edu.rice.cs.drjava.ui.MainFrame::handleRemoteOpenFile(File, int):void	edu.rice.cs.drjava.model.FileSaveSelector
edu.rice.cs.drjava.ui.MainFrame::_addGUIAvailabilityListener(Action, GUIAvailabilityListener.ComponentType[]):void	edu.rice.cs.drjava.ui.avail.DefaultGUIAvailabilityNotifier
edu.rice.cs.drjava.ui.config.ConfigFrame::_getWorkDir():File	edu.rice.cs.drjava.ui.MainFrame
edu.rice.cs.drjava.ui.MainFrame::removeMenuBarInOtherFrame(JMenuBar):void	edu.rice.cs.drjava.ui.RecentFileManager
edu.rice.cs.drjava.model.debug.jpda.JPDADebugger::getLLLocation(Location, List<File>):Location	edu.rice.cs.drjava.model.debug.jpda.PendingRequestManager
edu.rice.cs.drjava.model.debug.DebugTestCase::_doSetCurrentThread(DebugThreadData):void	edu.rice.cs.drjava.model.debug.DebugThreadData
edu.rice.cs.drjava.model.repl.InteractionsDJDocument::testHistoryRecallNextMovesToEnd(InteractionsPaneTest):void	edu.rice.cs.drjava.ui.InteractionsPaneTest
edu.rice.cs.drjava.ui.DefinitionsPane::setPositionAndScroll(int):void	edu.rice.cs.drjava.ui.ErrorCaretListener
edu.rice.cs.drjava.DrJavaTestCase::setConfigSetting(Option<T>, T):void	edu.rice.cs.drjava.config.Option
edu.rice.cs.drjava.ui.MainFrame::refreshBreakpointHighlightPainter():void	edu.rice.cs.drjava.ui.DefinitionsPane
edu.rice.cs.drjava.ui.MainFrame::_setDebugMenuItemsEnabled(boolean):void	edu.rice.cs.drjava.ui.avail.DefaultGUIAvailabilityNotifier
edu.rice.cs.drjava.ui.GenerateCustomDrJavaJarFrame::addZipFile(File, MD5ChecksumProperties, StringBuilder, ZipOutputStream, Predicate<String>):boolean	edu.rice.cs.util.MD5ChecksumProperties
edu.rice.cs.drjava.ui.MainFrame::createFindResultsPanel(RegionManager<MovingDocumentRegion>, MovingDocumentRegion, String, String, boolean, boolean, boolean, boolean, boolean, boolean, WeakReference<OpenDefinitionsDocument>, FindReplacePanel):FindResultsPanel	edu.rice.cs.drjava.ui.FindReplacePanel
edu.rice.cs.drjava.ui.MainFrame::_disableInteractionsPane():void	edu.rice.cs.drjava.ui.InteractionsScriptController
edu.rice.cs.drjava.ui.MainFrame::hourglassOff():void	edu.rice.cs.drjava.ui.DefinitionsPane
edu.rice.cs.drjava.ui.MainFrame::_showFileMovedError(FileMovedException):void	edu.rice.cs.drjava.model.FileMovedException
edu.rice.cs.drjava.ui.MainFrame::_setUpStatusBar():void	edu.rice.cs.drjava.ui.AboutDialog
edu.rice.cs.drjava.ui.MainFrame::testNE(CommandLineTest):void	edu.rice.cs.drjava.CommandLineTest
edu.rice.cs.drjava.model.FindReplaceMachine::findPrevious(FindReplacePanel):void	edu.rice.cs.drjava.ui.FindReplacePanel
edu.rice.cs.drjava.model.AbstractGlobalModel::addToBrowserHistory(boolean):void	edu.rice.cs.drjava.model.BrowserHistoryManager
edu.rice.cs.drjava.ui.MainFrame::_addGUIAvailabilityListener(Component, GUIAvailabilityListener.ComponentType[]):void	edu.rice.cs.drjava.ui.avail.DefaultGUIAvailabilityNotifier
edu.rice.cs.drjava.model.AbstractGlobalModel::openFileHelper(FileOpenSelector):OpenDefinitionsDocument	edu.rice.cs.util.FileOpenSelector
edu.rice.cs.drjava.ui.MainFrame::proposeBetterFileName(File):File	edu.rice.cs.util.FileOpenSelector
edu.rice.cs.drjava.model.GlobalModelTestCase::getCompilerErrorString():String	edu.rice.cs.drjava.model.DefaultGlobalModel
edu.rice.cs.util.text.ConsoleDocument::saveCopy(FileSaveSelector):void	edu.rice.cs.drjava.model.FileSaveSelector
edu.rice.cs.drjava.ui.MainFrame::_updateToolbarButtons():void	edu.rice.cs.drjava.ui.InteractionsScriptPane
edu.rice.cs.drjava.model.GlobalModelTestCase::interpret(String):String	edu.rice.cs.util.Log
edu.rice.cs.drjava.model.repl.InteractionsModel::loadHistoryAsScript(FileOpenSelector):InteractionsScriptModel	edu.rice.cs.util.FileOpenSelector
edu.rice.cs.drjava.ui.MainFrame::resetEditExternalProcessPosition():void	edu.rice.cs.drjava.ui.EditExternalDialog
edu.rice.cs.drjava.ui.MainFrame::getSaveFile(JFileChooser):File	edu.rice.cs.util.FileOpenSelector
edu.rice.cs.drjava.ui.DefinitionsPane::centerViewOnOffset(int):void	edu.rice.cs.drjava.ui.ErrorCaretListener
edu.rice.cs.drjava.ui.MainFrame::_createToolbarButton(Action):JButton	edu.rice.cs.drjava.ui.InteractionsScriptPane
edu.rice.cs.drjava.ui.MainFrame::initEditExternalProcessDialog():void	edu.rice.cs.drjava.ui.EditExternalDialog
edu.rice.cs.drjava.ui.MainFrame::_setMainFont():void	edu.rice.cs.drjava.ui.FindReplacePanel
edu.rice.cs.drjava.ui.MainFrame::hideRecentDocFrame():void	edu.rice.cs.drjava.ui.RecentDocFrame
edu.rice.cs.drjava.ui.config.VectorFileOptionComponent::reset2(ProjectPropertiesFrame, File):void	edu.rice.cs.drjava.ui.ProjectPropertiesFrame
edu.rice.cs.drjava.model.GlobalModelTestCase.JUnitTestListener::runJUnit(JUnitModel):void	edu.rice.cs.drjava.model.junit.JUnitModel
edu.rice.cs.drjava.ui.MainFrame::_enableInteractionsPane():void	edu.rice.cs.drjava.ui.InteractionsScriptController
edu.rice.cs.drjava.ui.MainFrame::_createTab(TabbedPanel):void	edu.rice.cs.drjava.ui.TabbedPanel
edu.rice.cs.drjava.ui.GenerateCustomDrJavaJarFrame::addDirectory(File, MD5ChecksumProperties, StringBuilder, ZipOutputStream, Predicate<String>):boolean	edu.rice.cs.util.MD5ChecksumProperties
edu.rice.cs.util.sexp.SExpParser.ParseHelper::parseAtom(Tokens.SExpToken):Atom	edu.rice.cs.util.sexp.Lexer
edu.rice.cs.drjava.model.AbstractGlobalModel::makeProjectFileGroupingState(File, String, File, File, File, File[], File[], File[], Iterable<AbsRelFile>, File, int, boolean, String):FileGroupingState	edu.rice.cs.drjava.model.FileGroupingState
edu.rice.cs.drjava.ui.ErrorPanel.ErrorListPane::addActionForKeyStroke(Vector<KeyStroke>, Action):void	edu.rice.cs.util.swing.HighlightManager
edu.rice.cs.drjava.ui.MainFrame::removeTab(Component):void	edu.rice.cs.drjava.ui.DefinitionsPane
edu.rice.cs.drjava.model.AbstractGlobalModel::_makeProjectProfile(File, HashMap<OpenDefinitionsDocument,DocumentInfoGetter>):ProjectProfile	edu.rice.cs.drjava.model.ConcreteRegionManager
edu.rice.cs.drjava.model.BrowserHistoryManager::changeRegion(BrowserDocumentRegion, Lambda<BrowserDocumentRegion,Object>):void	edu.rice.cs.drjava.model.BrowserDocumentRegion
edu.rice.cs.drjava.model.debug.jpda.JPDADebugger::LLBreakpointLineNum(Breakpoint):int	edu.rice.cs.drjava.model.debug.jpda.PendingRequestManager
edu.rice.cs.drjava.model.junit.JUnitTestManager::_isJUnitTest(Class<?>):boolean	edu.rice.cs.drjava.model.junit.JUnitTestRunner
edu.rice.cs.drjava.ui.MainFrame::_addMenuItem(JMenu, Action, VectorOption<KeyStroke>, int, boolean):JMenuItem	edu.rice.cs.util.swing.DelegatingAction
edu.rice.cs.drjava.model.AbstractGlobalModel::_loadProject(ProjectFileIR):void	edu.rice.cs.drjava.model.ConcreteRegionManager
edu.rice.cs.drjava.ui.JUnitPanel::_displayStackTrace(JUnitError):void	edu.rice.cs.drjava.model.junit.JUnitError
edu.rice.cs.drjava.ui.MainFrame::resetCompleteWordDialogPosition():void	edu.rice.cs.drjava.ui.AutoCompletePopup
edu.rice.cs.drjava.ui.MainFrame::_updateToolbarButton(JButton, Action):JButton	edu.rice.cs.drjava.ui.InteractionsScriptPane
edu.rice.cs.drjava.ui.ExecuteExternalDialog::colorVariables(JTextPane, PropertyMaps, DocumentListener, SimpleAttributeSet, SimpleAttributeSet, SimpleAttributeSet):void	edu.rice.cs.drjava.config.PropertyMaps
edu.rice.cs.drjava.model.AbstractGlobalModel::openFilesHelper(FileOpenSelector):OpenDefinitionsDocument[]	edu.rice.cs.util.FileOpenSelector
edu.rice.cs.drjava.ui.MainFrame::makeFolderChooser(File):DirectoryChooser	edu.rice.cs.util.FileOpenSelector
edu.rice.cs.drjava.ui.MainFrame::_addMenuItem(JMenu, Action, VectorOption<KeyStroke>, boolean):JMenuItem	edu.rice.cs.util.swing.DelegatingAction
edu.rice.cs.drjava.ui.MainFrame::_doResetInteractions():void	edu.rice.cs.drjava.ui.InteractionsPane
edu.rice.cs.drjava.ui.MainFrame::_openFileOrProject():void	edu.rice.cs.util.swing.DirectoryChooser
edu.rice.cs.drjava.model.AbstractGlobalModel::_createOpenDefinitionsDocument(File):ConcreteOpenDefDoc	edu.rice.cs.drjava.model.FileGroupingState
edu.rice.cs.drjava.ui.MainFrame::_displayGUIComponentAvailabilityFrame():void	edu.rice.cs.drjava.ui.InteractionsScriptPane
edu.rice.cs.drjava.ui.MainFrame::_getFullFile(File):File	edu.rice.cs.util.FileOpenSelector
edu.rice.cs.drjava.ui.MainFrame::_setCurrentDirectory(File):void	edu.rice.cs.util.FileOpenSelector
edu.rice.cs.drjava.ui.MainFrame::getChosenFile(JFileChooser, int, File):File	edu.rice.cs.util.FileOpenSelector
edu.rice.cs.drjava.ui.MainFrame::_hideDebuggerPanel():void	edu.rice.cs.drjava.ui.DetachedFrame
edu.rice.cs.drjava.ui.MainFrame::_showConfigException():void	edu.rice.cs.drjava.ui.EditExternalDialog
edu.rice.cs.drjava.config.OptionMapLoader::loadInto(OptionMap):void	edu.rice.cs.drjava.config.DefaultOptionMap
edu.rice.cs.drjava.ui.MainFrame::_setCurrentDirectory(OpenDefinitionsDocument):void	edu.rice.cs.drjava.model.FileSaveSelector
edu.rice.cs.drjava.ui.MainFrame::_followFile():void	edu.rice.cs.util.FileOpenSelector
edu.rice.cs.drjava.ui.MainFrame::getChosenFiles(JFileChooser, int):File[]	edu.rice.cs.util.FileOpenSelector
edu.rice.cs.drjava.ui.config.ConfigFrame::addOptionComponent(ConfigPanel, OptionComponent<X,C>):void	edu.rice.cs.drjava.ui.config.ConfigPanel
edu.rice.cs.drjava.ui.MainFrame::_createManualToolbarButton(Action):JButton	edu.rice.cs.drjava.ui.InteractionsScriptPane
edu.rice.cs.drjava.ui.GenerateCustomDrJavaJarFrame::addOptionsPropertiesFile(ZipOutputStream):void	edu.rice.cs.drjava.ui.config.VectorFileOptionComponent
edu.rice.cs.util.swing.FileChooser::_runCommand(ExecuteExternalDialog):void	edu.rice.cs.drjava.ui.ExecuteExternalDialog
edu.rice.cs.drjava.ui.MainFrame::_storePositionInfo():void	edu.rice.cs.drjava.ui.AutoCompletePopup
edu.rice.cs.drjava.ui.MainFrame::getOpenFiles(JFileChooser):File[]	edu.rice.cs.util.FileOpenSelector
edu.rice.cs.drjava.ui.ErrorPanel.ErrorListPane::_errorAtPoint(Point):DJError	edu.rice.cs.util.swing.HighlightManager
edu.rice.cs.drjava.ui.MainFrame::addMenuBarInOtherFrame(JMenuBar):void	edu.rice.cs.drjava.ui.RecentFileManager
edu.rice.cs.drjava.model.GlobalModelTestCase::getInteractionsText():String	edu.rice.cs.drjava.model.DefaultGlobalModel
edu.rice.cs.drjava.ui.MainFrame::_setUpActions():void	edu.rice.cs.util.swing.DelegatingAction
edu.rice.cs.drjava.ui.FindResultsPanel::_bookmark():void	edu.rice.cs.drjava.model.MovingDocumentRegion
edu.rice.cs.drjava.model.javadoc.DefaultJavadocModel::_getFileFromDocument(OpenDefinitionsDocument, FileSaveSelector):File	edu.rice.cs.drjava.model.FileSaveSelector
edu.rice.cs.drjava.ui.MainFrame::hourglassOn():void	edu.rice.cs.drjava.ui.DefinitionsPane
edu.rice.cs.drjava.model.AbstractGlobalModel::saveAllFilesHelper(FileSaveSelector):void	edu.rice.cs.drjava.model.FileSaveSelector
edu.rice.cs.drjava.model.definitions.indent.Indenter::indent(AbstractDJDocument, Indenter.IndentReason):boolean	edu.rice.cs.drjava.model.definitions.indent.IndentRule
edu.rice.cs.drjava.model.GlobalModelTestCase::interpretIgnoreResult(String):void	edu.rice.cs.drjava.model.DefaultGlobalModel
edu.rice.cs.util.swing.DirectoryChooser::_setUpLanguageLevelMenu(MainFrame, int, boolean):JMenu	edu.rice.cs.drjava.ui.MainFrame
edu.rice.cs.drjava.model.definitions.DefinitionsDocument::_findPrevKeyword(String, String, int):int	edu.rice.cs.drjava.model.definitions.reducedmodel.ReducedModelControl
edu.rice.cs.drjava.model.compiler.DefaultCompilerModel::_visitorErrors2CompilerErrors(LinkedList<Pair<String,JExpressionIF>>):LinkedList<DJError>	edu.rice.cs.drjava.model.compiler.CompilerErrorModel
edu.rice.cs.drjava.ui.MainFrame::_setUpFileMenu(int, boolean):JMenu	edu.rice.cs.util.swing.DelegatingAction
edu.rice.cs.drjava.model.debug.jpda.JPDADebugger::getLLStackTraceElement(Location, List<File>):StackTraceElement	edu.rice.cs.drjava.model.debug.jpda.PendingRequestManager
edu.rice.cs.drjava.model.debug.jpda.JPDADebugger::openAndScroll(OpenDefinitionsDocument, Location, boolean):void	edu.rice.cs.drjava.model.debug.jpda.PendingRequestManager
edu.rice.cs.drjava.model.definitions.DefinitionsDocument::_findNextOpenCurly(String, int):int	edu.rice.cs.drjava.model.definitions.reducedmodel.ReducedModelControl
edu.rice.cs.drjava.ui.ExecuteExternalDialog::chooseFile(JTextPane):void	edu.rice.cs.util.swing.FileChooser
edu.rice.cs.drjava.ui.ExecuteExternalDialog::runCommand(String, String, String, String, PropertyMaps):ExternalProcessPanel	edu.rice.cs.util.swing.FileChooser
edu.rice.cs.drjava.ui.MainFrame::_setUpKeyBindingMaps():void	edu.rice.cs.drjava.ui.DefinitionsPane
edu.rice.cs.drjava.ui.MainFrame::_showDebuggerPanel():void	edu.rice.cs.drjava.ui.DetachedFrame
edu.rice.cs.drjava.model.TestDocGetter::testConstructOneDocWithoutLineNums(CompilerErrorModelTest):void	edu.rice.cs.drjava.model.compiler.CompilerErrorModelTest
edu.rice.cs.drjava.config.ConfigOptionListeners.RequiresInteractionsRestartListener::_setupNotificationsPanel(ConfigFrame, ConfigPanel):void	edu.rice.cs.drjava.ui.config.ConfigFrame
edu.rice.cs.drjava.ui.MainFrame::_setMenuShortcut(JMenuItem, Action, VectorOption<KeyStroke>, boolean):void	edu.rice.cs.util.swing.DelegatingAction
edu.rice.cs.drjava.model.definitions.DefinitionsDocument::containsClassOrInterfaceOrEnum():boolean	edu.rice.cs.drjava.model.definitions.reducedmodel.ReducedModelControl
