org.apache.tapestry5.internal.pageload.PageLoaderImpl::cdata(org.apache.tapestry5.internal.pageload.AssemblerContext):void	org.apache.tapestry5.internal.pageload.AssemblerContext
org.apache.tapestry5.internal.pageload.PageLoaderImpl::defineNamespacePrefix(org.apache.tapestry5.internal.pageload.AssemblerContext):void	org.apache.tapestry5.internal.pageload.AssemblerContext
org.apache.tapestry5.internal.pageload.PageLoaderImpl::dtd(org.apache.tapestry5.internal.pageload.AssemblerContext):void	org.apache.tapestry5.internal.pageload.AssemblerContext
org.apache.tapestry5.internal.pageload.PageLoaderImpl::comment(org.apache.tapestry5.internal.pageload.AssemblerContext):void	org.apache.tapestry5.internal.pageload.AssemblerContext
org.apache.tapestry5.internal.pageload.PageLoaderImpl::text(org.apache.tapestry5.internal.pageload.AssemblerContext):void	org.apache.tapestry5.internal.pageload.AssemblerContext
org.apache.tapestry5.internal.services.InternalClassTransformationImpl::match(javassist.CtMethod, org.apache.tapestry5.services.TransformMethodSignature):boolean	org.apache.tapestry5.services.TransformMethodSignature
org.apache.tapestry5.ioc.services.MethodSignature::failIfNotFrozen(org.apache.tapestry5.internal.services.InternalClassTransformationImpl):void	org.apache.tapestry5.internal.services.InternalClassTransformationImpl
org.apache.tapestry5.test.PageTester::extractNonBlank(org.apache.tapestry5.dom.Element, java.lang.String):java.lang.String	org.apache.tapestry5.dom.Element
org.apache.tapestry5.test.PageTester::assertIsSubmit(org.apache.tapestry5.dom.Element):void	org.apache.tapestry5.dom.Element
org.example.testapp.services.SpringStatusProvider::onSuccess(org.example.testapp.pages.Start):void	org.example.testapp.pages.Start
org.apache.tapestry.mojo.ComponentReport::readEvents(org.apache.tapestry.mojo.ClassDescription, nu.xom.Element):void	org.apache.tapestry.mojo.ClassDescription
org.apache.tapestry.mojo.ComponentReport::readParameters(org.apache.tapestry.mojo.ClassDescription, nu.xom.Element):void	org.apache.tapestry.mojo.ClassDescription
org.apache.tapestry.mojo.ComponentReport::readPublishedParameters(org.apache.tapestry.mojo.ClassDescription, nu.xom.Element):void	org.apache.tapestry.mojo.ClassDescription
org.apache.tapestry5.internal.services.ClientBehaviorSupportImpl::addFunction(org.apache.tapestry5.json.JSONObject, java.lang.String, java.lang.String):void	org.apache.tapestry5.json.JSONObject
org.apache.tapestry5.internal.services.StaxTemplateParser::ensureParameterWithinComponent(org.apache.tapestry5.internal.services.TemplateParserState):void	org.apache.tapestry5.internal.services.TemplateParserState
org.apache.tapestry5.internal.transform.OnEventWorker::extractComponentId(org.apache.tapestry5.services.TransformMethodSignature, org.apache.tapestry5.annotations.OnEvent):java.lang.String	org.apache.tapestry5.services.TransformMethodSignature
org.apache.tapestry5.internal.transform.OnEventWorker::extractEventType(org.apache.tapestry5.services.TransformMethodSignature, org.apache.tapestry5.annotations.OnEvent):java.lang.String	org.apache.tapestry5.services.TransformMethodSignature
org.apache.tapestry5.ioc.internal.services.ChainBuilderImpl::addVoidMethod(org.apache.tapestry5.ioc.services.ClassFab, java.lang.Class, org.apache.tapestry5.ioc.services.MethodSignature):void	org.apache.tapestry5.ioc.services.MethodSignature
org.apache.tapestry5.test.PageTester::validateElementName(org.apache.tapestry5.dom.Element, java.lang.String):void	org.apache.tapestry5.dom.Element
org.apache.tapestry5.json.JSONArray::parse(org.apache.tapestry5.json.JSONTokener):void	org.apache.tapestry5.json.JSONTokener
org.apache.tapestry5.corelib.mixins.NotEmpty::afterRender():void	org.apache.tapestry5.dom.Element
org.apache.tapestry5.internal.pageload.PageLoaderImpl::attribute(org.apache.tapestry5.internal.pageload.AssemblerContext):void	org.apache.tapestry5.internal.pageload.AssemblerContext
org.apache.tapestry5.internal.services.RenderSupportImpl::addInitFunctionInvocation(java.lang.String, java.lang.Object):void	org.apache.tapestry5.json.JSONObject
org.apache.tapestry5.ioc.internal.services.FilterMethodAnalyzer::findServiceInterfacePosition(org.apache.tapestry5.ioc.services.MethodSignature, org.apache.tapestry5.ioc.services.MethodSignature):int	org.apache.tapestry5.ioc.services.MethodSignature
org.apache.tapestry5.dom.Element::addMappingIfNeeded(org.apache.tapestry5.dom.MapHolder, java.lang.String):void	org.apache.tapestry5.dom.MapHolder
org.apache.tapestry5.internal.pageload.PageLoaderImpl::queueOverrideTokensForExtensionPoint(org.apache.tapestry5.internal.parser.ExtensionPointToken, org.apache.tapestry5.ioc.util.Stack<org.apache.tapestry5.internal.parser.TemplateToken>, java.util.List<org.apache.tapestry5.internal.parser.ComponentTemplate>):void	org.apache.tapestry5.internal.parser.ExtensionPointToken
org.apache.tapestry5.internal.pageload.PageLoaderImpl::expansion(org.apache.tapestry5.internal.pageload.AssemblerContext):void	org.apache.tapestry5.internal.pageload.AssemblerContext
org.apache.tapestry5.internal.services.ClientBehaviorSupportImpl::addElementInit(java.lang.String, java.lang.String, org.apache.tapestry5.json.JSONObject):void	org.apache.tapestry5.json.JSONObject
org.apache.tapestry5.internal.transform.RenderPhaseMethodWorker::addMethodCallToBody(org.apache.tapestry5.ioc.util.BodyBuilder, org.apache.tapestry5.services.TransformMethodSignature, org.apache.tapestry5.services.ClassTransformation):void	org.apache.tapestry5.ioc.util.BodyBuilder
org.apache.tapestry5.internal.util.MethodInvocationBuilder::buildMethodInvocation(org.apache.tapestry5.services.TransformMethodSignature, org.apache.tapestry5.services.ClassTransformation):java.lang.String	org.apache.tapestry5.services.TransformMethodSignature
org.apache.tapestry5.ioc.internal.services.BridgeBuilder::addBridgeMethod(int, org.apache.tapestry5.ioc.services.MethodSignature, org.apache.tapestry5.ioc.services.MethodSignature):void	org.apache.tapestry5.ioc.services.MethodSignature
org.apache.tapestry5.internal.services.InternalClassTransformationImpl::addMethodToDescription(java.lang.String, org.apache.tapestry5.services.TransformMethodSignature, java.lang.String):void	org.apache.tapestry5.services.TransformMethodSignature
org.apache.tapestry5.internal.pageload.PageLoaderImpl::consumeToEndElementAndPopBodyElement(org.apache.tapestry5.internal.pageload.AssemblerContext):void	org.apache.tapestry5.internal.pageload.AssemblerContext
