org.apache.tapestry5.internal.services.InternalClassTransformationImpl::match(CtMethod, TransformMethodSignature):boolean	org.apache.tapestry5.services.TransformMethodSignature
org.apache.tapestry5.corelib.components.Select::beginRender(MarkupWriter):void	org.apache.tapestry5.corelib.mixins.RenderDisabled
org.apache.tapestry5.internal.services.InternalModule::buildStringInterner(StringInternerImpl):StringInterner	org.apache.tapestry5.internal.services.StringInternerImpl
org.apache.tapestry.mojo.ComponentReport::readPublishedParameters(ClassDescription, Element):void	org.apache.tapestry.mojo.ClassDescription
org.apache.tapestry5.ioc.RegistryBuilder::build():Registry	org.apache.tapestry5.ioc.internal.util.OneShotLock
org.apache.tapestry5.internal.pageload.PageLoaderImpl::attribute(AssemblerContext):void	org.apache.tapestry5.internal.pageload.AssemblerContext
org.apache.tapestry5.internal.services.ComponentInstantiatorSourceImpl::addClassFileToChangeTracker(String):void	org.apache.tapestry5.internal.util.URLChangeTracker
org.apache.tapestry5.internal.services.InternalModule::buildComponentClassCache(ComponentClassCacheImpl):ComponentClassCache	org.apache.tapestry5.internal.services.ComponentClassCacheImpl
org.apache.tapestry5.internal.pageload.PageAssembly::addRenderCommand(RenderCommand):void	org.apache.tapestry5.ioc.util.Stack
org.apache.tapestry5.corelib.components.Palette::beginRender(MarkupWriter):void	org.apache.tapestry5.internal.util.SelectModelRenderer
org.apache.tapestry5.services.BeanBlockContribution::toBlock(BeanBlockOverrideSourceImpl):Block	org.apache.tapestry5.internal.services.BeanBlockOverrideSourceImpl
org.apache.tapestry5.test.TapestryTestCase::train_addMethod(ClassTransformation, TransformMethodSignature, String[]):void	org.apache.tapestry5.services.TransformMethodSignature
org.apache.tapestry5.internal.pageload.PageLoaderImpl::queueOverrideTokensForExtensionPoint(ExtensionPointToken, Stack<TemplateToken>, List<ComponentTemplate>):void	org.apache.tapestry5.ioc.util.Stack
org.apache.tapestry5.test.TapestryTestCase::train_extendMethod(ClassTransformation, TransformMethodSignature, String[]):void	org.apache.tapestry5.services.TransformMethodSignature
org.apache.tapestry5.dom.Element::addMappingIfNeeded(MapHolder, String):void	org.apache.tapestry5.dom.MapHolder
org.apache.tapestry5.internal.pageload.PageLoaderImpl::comment(AssemblerContext):void	org.apache.tapestry5.internal.pageload.AssemblerContext
org.apache.tapestry5.corelib.components.FormFragment::afterRender(MarkupWriter):void	org.apache.tapestry5.corelib.internal.HiddenFieldPositioner
org.apache.tapestry5.internal.services.InternalClassTransformationImplTest::findCtClass(Class):CtClass	org.apache.tapestry5.ioc.internal.services.ClassFactoryClassPool
org.apache.tapestry5.dom.Element::writeChildMarkup(Document, PrintWriter, Map<String,String>):void	org.apache.tapestry5.dom.Document
org.apache.tapestry.mojo.ComponentReportTest::generate(ComponentReport, File):StringWriter	org.apache.tapestry.mojo.ComponentReport
org.apache.tapestry5.services.TapestryModule::contributeApplicationInitializer(OrderedConfiguration<ApplicationInitializerFilter>, TypeCoercer, ComponentClassResolver, InvalidationEventHub, RestoreDirtySessionObjects):void	org.apache.tapestry5.internal.services.RestoreDirtySessionObjects
org.apache.tapestry5.internal.pageload.ComponentAssemblerImpl::pushNewElement(PageAssembly, ComponentPageElement):void	org.apache.tapestry5.internal.pageload.PageAssembly
org.apache.tapestry5.services.TapestryModule::buildPropBindingFactory(List<BindingFactory>, PropBindingFactory):BindingFactory	org.apache.tapestry5.internal.bindings.PropBindingFactory
org.apache.tapestry.mojo.ComponentReport::readParameters(ClassDescription, Element):void	org.apache.tapestry.mojo.ClassDescription
org.apache.tapestry5.services.TapestryModule::buildMarkupRenderer(Logger, MarkupRendererTerminator, List<MarkupRendererFilter>):MarkupRenderer	org.apache.tapestry5.internal.services.MarkupRendererTerminator
org.apache.tapestry5.internal.services.InternalClassTransformationImplTest::toClass(CtClass):Class	org.apache.tapestry5.ioc.internal.services.ClassFactoryClassPool
org.apache.tapestry5.corelib.mixins.RenderDisabled::defaultModel(Select):SelectModel	org.apache.tapestry5.corelib.components.Select
org.apache.tapestry5.internal.services.ComponentRequestHandlerTerminator::buildComponentRequestHandler(List<ComponentRequestFilter>, TapestryModule, Logger):ComponentRequestHandler	org.apache.tapestry5.services.TapestryModule
org.apache.tapestry5.internal.services.InternalModule::buildResourceCache(ResourceCacheImpl):ResourceCache	org.apache.tapestry5.internal.services.ResourceCacheImpl
org.apache.tapestry5.corelib.components.Form::executeStoredActions():void	org.apache.tapestry5.corelib.internal.ComponentActionSink
org.apache.tapestry5.internal.pageload.PageAssembly::checkForRecursion(String, Location):void	org.apache.tapestry5.ioc.util.Stack
org.apache.tapestry5.internal.grid.CollectionGridDataSourceTest::sort(String, boolean, int[]):void	org.apache.tapestry5.internal.grid.CollectionGridDataSource
org.apache.tapestry5.services.TapestryModule::buildPartialMarkupRenderer(Logger, List<PartialMarkupRendererFilter>, PartialMarkupRendererTerminator):PartialMarkupRenderer	org.apache.tapestry5.internal.services.PartialMarkupRendererTerminator
