org.jfree.chart.renderer.xy.XYBarRenderer::calculateLabelAnchorPoint(ItemLabelAnchor, Rectangle2D, PlotOrientation):Point2D	org.jfree.chart.plot.PlotOrientation
org.jfree.data.jdbc.JDBCCategoryDataset::executeQuery(Connection, String):void	org.jfree.data.DefaultKeyedValues2D
org.jfree.chart.plot.PiePlot::initialise(Graphics2D, Rectangle2D, PiePlot, Integer, PlotRenderingInfo):PiePlotState	org.jfree.chart.plot.PlotRenderingInfo
org.jfree.chart.junit.TimeSeriesChartTests::testDrawWithNullInfo():void	org.jfree.chart.JFreeChart
org.jfree.chart.renderer.xy.AbstractXYItemRenderer::calculateDomainMarkerTextAnchorPoint(Graphics2D, PlotOrientation, Rectangle2D, Rectangle2D, RectangleInsets, LengthAdjustmentType, RectangleAnchor):Point2D	org.jfree.chart.plot.PlotOrientation
org.jfree.chart.renderer.category.AbstractCategoryItemRenderer::calculateDomainMarkerTextAnchorPoint(Graphics2D, PlotOrientation, Rectangle2D, Rectangle2D, RectangleInsets, LengthAdjustmentType, RectangleAnchor):Point2D	org.jfree.chart.plot.PlotOrientation
org.jfree.chart.plot.WaferMapPlot::setDataset(WaferMapDataset):void	org.jfree.data.general.WaferMapDataset
org.jfree.chart.renderer.xy.XYDifferenceRenderer::createPolygon(Graphics2D, Rectangle2D, XYPlot, ValueAxis, ValueAxis, boolean, LinkedList, LinkedList):void	org.jfree.chart.plot.XYPlot
org.jfree.chart.plot.CategoryPlot::drawRangeCrosshair(Graphics2D, Rectangle2D, PlotOrientation, double, ValueAxis, Stroke, Paint):void	org.jfree.chart.axis.ValueAxis
org.jfree.chart.junit.BarChartTests::testDrawWithNullInfo():void	org.jfree.chart.JFreeChart
org.jfree.chart.plot.SpiderWebPlot::getPlotValue(int, int):Number	org.jfree.chart.labels.CategoryItemLabelGenerator
org.jfree.chart.axis.Axis::createAndAddEntity(double, AxisState, Rectangle2D, RectangleEdge, PlotRenderingInfo):void	org.jfree.chart.plot.PlotRenderingInfo
org.jfree.chart.junit.XYStepAreaChartTests::testDrawWithNullInfo():void	org.jfree.chart.JFreeChart
org.jfree.chart.plot.PolarPlot::drawCornerTextItems(Graphics2D, Rectangle2D):void	org.jfree.chart.renderer.PolarItemRenderer
org.jfree.chart.junit.StackedBarChart3DTests::testDrawWithNullInfo():void	org.jfree.chart.JFreeChart
org.jfree.chart.renderer.category.AbstractCategoryItemRenderer::calculateRangeMarkerTextAnchorPoint(Graphics2D, PlotOrientation, Rectangle2D, Rectangle2D, RectangleInsets, LengthAdjustmentType, RectangleAnchor):Point2D	org.jfree.chart.plot.PlotOrientation
org.jfree.chart.renderer.xy.AbstractXYItemRenderer::findDomainBounds(XYDataset, boolean):Range	org.jfree.chart.labels.XYItemLabelGenerator
org.jfree.chart.axis.PeriodAxis::drawTickMarksVertical(Graphics2D, AxisState, Rectangle2D, RectangleEdge):void	org.jfree.chart.axis.AxisState
org.jfree.chart.plot.PiePlot::getMaximumExplodePercent():double	org.jfree.chart.labels.PieToolTipGenerator
org.jfree.chart.ChartPanel::getScreenDataArea():Rectangle2D	org.jfree.chart.ChartRenderingInfo
org.jfree.chart.editor.DefaultColorBarEditor::attemptPaletteSelection():void	org.jfree.chart.editor.PaletteSample
org.jfree.chart.renderer.xy.AbstractXYItemRenderer::calculateRangeMarkerTextAnchorPoint(Graphics2D, PlotOrientation, Rectangle2D, Rectangle2D, RectangleInsets, LengthAdjustmentType, RectangleAnchor):Point2D	org.jfree.chart.plot.PlotOrientation
org.jfree.chart.junit.PieChart3DTests::testReplaceDatasetOnPieChart():void	org.jfree.chart.JFreeChart
org.jfree.chart.junit.ScatterPlotTests::testDrawWithNullInfo():void	org.jfree.chart.JFreeChart
org.jfree.chart.plot.PiePlot::drawRightLabel(Graphics2D, PiePlotState, PieLabelRecord):void	org.jfree.chart.plot.PiePlotState
org.jfree.chart.plot.XYPlot::drawAnnotations(Graphics2D, Rectangle2D, PlotRenderingInfo):void	org.jfree.chart.plot.PlotRenderingInfo
org.jfree.chart.plot.XYPlot::drawDomainCrosshair(Graphics2D, Rectangle2D, PlotOrientation, double, ValueAxis, Stroke, Paint):void	org.jfree.chart.axis.ValueAxis
org.jfree.chart.plot.PolarPlot::drawAxis(Graphics2D, Rectangle2D, Rectangle2D):AxisState	org.jfree.chart.renderer.PolarItemRenderer
org.jfree.chart.plot.Crosshair::writeObject(ObjectOutputStream):void	org.jfree.chart.labels.CrosshairLabelGenerator
org.jfree.chart.junit.XYBarChartTests::testDrawWithNullInfo():void	org.jfree.chart.JFreeChart
org.jfree.chart.junit.XYLineChartTests::testDrawWithNullInfo():void	org.jfree.chart.JFreeChart
org.jfree.chart.JFreeChart::draw(Graphics2D, Rectangle2D, ChartRenderingInfo):void	org.jfree.chart.ChartRenderingInfo
org.jfree.chart.junit.PieChartTests::testReplaceDatasetOnPieChart():void	org.jfree.chart.JFreeChart
org.jfree.chart.plot.PiePlot::drawItem(Graphics2D, int, Rectangle2D, PiePlotState, int):void	org.jfree.chart.labels.PieToolTipGenerator
org.jfree.chart.plot.PiePlot::getSectionOutlineStroke(Comparable):Stroke	org.jfree.chart.StrokeMap
org.jfree.chart.axis.NumberAxis::estimateMaximumTickLabelHeight(Graphics2D):double	org.jfree.chart.axis.MarkerAxisBand
org.jfree.chart.block.AbstractBlock::toContentConstraint(RectangleConstraint):RectangleConstraint	org.jfree.chart.block.RectangleConstraint
org.jfree.chart.plot.PiePlot::setDataset(PieDataset):void	org.jfree.chart.labels.PieToolTipGenerator
org.jfree.chart.renderer.category.CategoryStepRenderer::drawLine(Graphics2D, State, PlotOrientation, double, double, double, double):void	org.jfree.chart.plot.PlotOrientation
org.jfree.chart.renderer.category.AbstractCategoryItemRenderer::drawRangeLine(Graphics2D, CategoryPlot, ValueAxis, Rectangle2D, double, Paint, Stroke):void	org.jfree.chart.plot.CategoryPlot
org.jfree.chart.annotations.AbstractXYAnnotation::addEntity(PlotRenderingInfo, Shape, int, String, String):void	org.jfree.chart.plot.PlotRenderingInfo
org.jfree.chart.renderer.xy.XYBarRenderer::drawItemLabel(Graphics2D, XYDataset, int, int, XYPlot, XYItemLabelGenerator, Rectangle2D, boolean):void	org.jfree.chart.renderer.xy.XYBarPainter
org.jfree.chart.junit.LineChart3DTests::testDrawWithNullInfo():void	org.jfree.chart.JFreeChart
org.jfree.chart.renderer.xy.AbstractXYItemRenderer::drawDomainLine(Graphics2D, XYPlot, ValueAxis, Rectangle2D, double, Paint, Stroke):void	org.jfree.chart.plot.XYPlot
org.jfree.chart.JFreeChart::notifyListeners(ChartProgressEvent):void	org.jfree.chart.event.ChartProgressEvent
org.jfree.chart.plot.ContourPlot::setDataset(ContourDataset):void	org.jfree.chart.labels.ContourToolTipGenerator
org.jfree.chart.ChartPanel::getPointInRectangle(int, int, Rectangle2D):Point2D	org.jfree.chart.ChartRenderingInfo
org.jfree.chart.axis.NumberAxis::setRangeType(RangeType):void	org.jfree.data.RangeType
org.jfree.chart.junit.AreaChartTests::testDrawWithNullInfo():void	org.jfree.chart.JFreeChart
org.jfree.chart.renderer.category.BarRenderer::calculateLabelAnchorPoint(ItemLabelAnchor, Rectangle2D, PlotOrientation):Point2D	org.jfree.chart.plot.PlotOrientation
org.jfree.data.xml.PieDatasetHandler::addItem(Comparable, Number):void	org.jfree.data.general.DefaultPieDataset
org.jfree.chart.axis.CategoryAxis::drawCategoryLabels(Graphics2D, Rectangle2D, Rectangle2D, RectangleEdge, AxisState, PlotRenderingInfo):AxisState	org.jfree.chart.axis.CategoryLabelPositions
org.jfree.chart.junit.WaterfallChartTests::testDrawWithNullInfo():void	org.jfree.chart.JFreeChart
org.jfree.chart.junit.StackedAreaChartTests::testDrawWithNullInfo():void	org.jfree.chart.JFreeChart
org.jfree.chart.renderer.xy.XYLineAndShapeRenderer::drawPrimaryLine(XYItemRendererState, Graphics2D, XYPlot, XYDataset, int, int, int, ValueAxis, ValueAxis, Rectangle2D):void	org.jfree.chart.plot.XYPlot
org.jfree.chart.ClipPath::generateClipPath(Rectangle2D, ValueAxis, ValueAxis):GeneralPath	org.jfree.chart.axis.ValueAxis
org.jfree.chart.junit.XYAreaChartTests::testDrawWithNullInfo():void	org.jfree.chart.JFreeChart
org.jfree.chart.plot.PiePlot::drawSimpleLabels(Graphics2D, List, double, Rectangle2D, Rectangle2D, PiePlotState):void	org.jfree.chart.labels.PieToolTipGenerator
org.jfree.chart.plot.Plot::createAndAddEntity(Rectangle2D, PlotRenderingInfo, String, String):void	org.jfree.chart.plot.PlotRenderingInfo
org.jfree.data.xml.CategoryDatasetHandler::addItem(Comparable, Comparable, Number):void	org.jfree.data.category.DefaultCategoryDataset
org.jfree.chart.plot.ContourPlot::render(Graphics2D, Rectangle2D, PlotRenderingInfo, CrosshairState):void	org.jfree.chart.plot.PlotRenderingInfo
org.jfree.chart.plot.PiePlot::drawLeftLabel(Graphics2D, PiePlotState, PieLabelRecord):void	org.jfree.chart.plot.PiePlotState
org.jfree.chart.block.AbstractBlock::drawBorder(Graphics2D, Rectangle2D):void	org.jfree.chart.block.BlockFrame
org.jfree.chart.plot.MeterPlot::drawArcForInterval(Graphics2D, Rectangle2D, MeterInterval):void	org.jfree.chart.plot.MeterInterval
org.jfree.chart.plot.PiePlot::drawLabels(Graphics2D, List, double, Rectangle2D, Rectangle2D, PiePlotState):void	org.jfree.chart.labels.PieToolTipGenerator
org.jfree.chart.ChartPanel::getScreenDataArea(int, int):Rectangle2D	org.jfree.chart.ChartRenderingInfo
org.jfree.chart.renderer.category.AbstractCategoryItemRenderer::findRangeBounds(CategoryDataset, boolean):Range	org.jfree.chart.labels.CategoryItemLabelGenerator
org.jfree.chart.plot.PolarPlot::render(Graphics2D, Rectangle2D, PlotRenderingInfo):void	org.jfree.chart.renderer.PolarItemRenderer
org.jfree.chart.JFreeChart::drawTitle(Title, Graphics2D, Rectangle2D, boolean):EntityCollection	org.jfree.chart.title.Title
org.jfree.chart.axis.Axis::notifyListeners(AxisChangeEvent):void	org.jfree.chart.event.AxisChangeEvent
org.jfree.chart.junit.BarChart3DTests::testDrawWithNullInfo():void	org.jfree.chart.JFreeChart
org.jfree.chart.junit.XYStepChartTests::testDrawWithNullInfo():void	org.jfree.chart.JFreeChart
org.jfree.chart.renderer.category.BarRenderer::drawItemLabel(Graphics2D, CategoryDataset, int, int, CategoryPlot, CategoryItemLabelGenerator, Rectangle2D, boolean):void	org.jfree.chart.renderer.category.BarPainter
org.jfree.experimental.chart.swt.ChartComposite::getScreenDataArea():Rectangle	org.jfree.chart.ChartRenderingInfo
org.jfree.chart.plot.PiePlot::getSectionOutlinePaint(Comparable):Paint	org.jfree.chart.PaintMap
org.jfree.chart.junit.StackedBarChartTests::testDrawWithNullInfo():void	org.jfree.chart.JFreeChart
org.jfree.chart.plot.SpiderWebPlot::setDataset(CategoryDataset):void	org.jfree.chart.labels.CategoryItemLabelGenerator
org.jfree.chart.junit.LineChartTests::testDrawWithNullInfo():void	org.jfree.chart.JFreeChart
org.jfree.chart.title.PaintScaleLegend::arrangeRR(Graphics2D, Range, Range):Size2D	org.jfree.chart.axis.ValueAxis
org.jfree.chart.plot.PolarPlot::drawGridlines(Graphics2D, Rectangle2D, List, List):void	org.jfree.chart.renderer.PolarItemRenderer
org.jfree.chart.plot.PiePlot::getSectionPaint(Comparable):Paint	org.jfree.chart.PaintMap
org.jfree.data.statistics.HistogramDataset::setType(HistogramType):void	org.jfree.data.statistics.HistogramType
org.jfree.chart.plot.PolarPlot::translateValueThetaRadiusToJava2D(double, double, Rectangle2D):Point	org.jfree.chart.renderer.PolarItemRenderer
org.jfree.chart.renderer.category.AbstractCategoryItemRenderer::updateCrosshairValues(CategoryCrosshairState, Comparable, Comparable, double, int, double, double, PlotOrientation):void	org.jfree.chart.plot.CategoryCrosshairState
org.jfree.chart.plot.CategoryPlot::calculateRangeAxisSpace(Graphics2D, Rectangle2D, AxisSpace):AxisSpace	org.jfree.chart.axis.AxisSpace
org.jfree.chart.plot.XYPlot::drawRangeCrosshair(Graphics2D, Rectangle2D, PlotOrientation, double, ValueAxis, Stroke, Paint):void	org.jfree.chart.axis.ValueAxis
org.jfree.chart.JFreeChart::createAlignedRectangle2D(Size2D, Rectangle2D, HorizontalAlignment, VerticalAlignment):Rectangle2D	org.jfree.chart.title.TextTitle
