org.junit.experimental.theories.internal.Assignments::getAnnotatedSupplier(ParameterSignature):ParameterSupplier	org.junit.experimental.theories.ParameterSignature	INOK	GNOK
org.junit.experimental.theories.internal.AllMembersSupplier::addSinglePointMethods(ParameterSignature, List<PotentialAssignment>):void	org.junit.runners.model.TestClass	IOK	GNOK
org.junit.runner.notification.RunNotifier::runTestMethod(MethodRoadie):void	org.junit.internal.runners.MethodRoadie	IOK	GOK
org.junit.runner.manipulation.Filter::filter2(JUnit38ClassRunner):void	org.junit.internal.runners.JUnit38ClassRunner	IOK	GOK
org.junit.runners.model.Statement::evaluate2(ExpectException):void	org.junit.internal.runners.statements.ExpectException	INOK	GNOK
org.junit.internal.runners.JUnit4ClassRunner::testAborted(RunNotifier, Description, Throwable):void	org.junit.runner.Description	IOK	GNOK
org.junit.runner.Description::runBefores(ClassRoadie):void	org.junit.internal.runners.ClassRoadie	INOK	GOK
org.junit.runners.Parameterized::getParametersMethod(TestClass):FrameworkMethod	org.junit.runners.model.TestClass	INOK	GNOK
org.junit.internal.runners.JUnit4ClassRunner::classAnnotations():Annotation[]	org.junit.internal.runners.TestClass	IOK	GNOK
junit.framework.JUnit4TestAdapterCache::getNotifier(TestResult, JUnit4TestAdapter):RunNotifier	junit.framework.TestResult	INOK	GNOK
org.junit.runners.ParentRunner::runLeaf(Statement, Description, RunNotifier):void	org.junit.runner.Description	INOK	GNOK
org.junit.runner.Computer::getRunner(RunnerBuilder, Class<?>):Runner	org.junit.runners.model.RunnerBuilder	IOK	GNOK
org.junit.experimental.theories.Theories.TheoryAnchor::runWithIncompleteAssignment(Assignments):void	org.junit.experimental.theories.internal.Assignments	IOK	GNOK
org.junit.runner.manipulation.Filter::filter3(JUnit4ClassRunner):void	org.junit.internal.runners.JUnit4ClassRunner	IOK	GOK
org.junit.experimental.theories.ParameterSignature::addFields(AllMembersSupplier, List<PotentialAssignment>):void	org.junit.experimental.theories.internal.AllMembersSupplier	INOK	GOK
org.junit.runner.Computer::getSuite(RunnerBuilder, Class<?>[]):Runner	org.junit.runners.model.RunnerBuilder	INOK	GNOK
org.junit.runners.ParentRunner::validatePublicVoidNoArgMethods(Class<? extends Annotation>, boolean, List<Throwable>):void	org.junit.runners.model.TestClass	INOK	GNOK

JMove
17	19	REC
5	5	GOK
0.29	0.26	PRE
0.70	0.74	FPO

JMove + IUC
8	8	REC
3	4	GOK
0.38	0.5	PRE
0.62	0.5	FPO

Dimunuição
0.47	0.68	-REC
0.60	0.20	-GOK
0.42	0.72	-FPO