br.com.linkcom.sgm.beans.ObjetivoMapaEstrategico::getDescricao():String	br.com.linkcom.sgm.beans.ObjetivoEstrategico
br.com.linkcom.sgm.beans.PerspectivaMapaEstrategico::getDescricao():String	br.com.linkcom.sgm.beans.Perspectiva
br.com.linkcom.sgm.controller.crud.AuditoriaInternaCrud::ajaxComboRequisito(WebRequestContext):void	br.com.linkcom.sgm.service.RequisitoNormaService
br.com.linkcom.sgm.controller.crud.AuditoriaInternaCrud::doSalvarEEncerrar(WebRequestContext, AuditoriaInterna):ModelAndView	br.com.linkcom.sgm.beans.AuditoriaInterna
br.com.linkcom.sgm.controller.crud.AuditoriaInternaCrud::doSalvarESolicitarEncerramento(WebRequestContext, AuditoriaInterna):ModelAndView	br.com.linkcom.sgm.beans.AuditoriaInterna
br.com.linkcom.sgm.controller.crud.IndicadorCrud::copiar(WebRequestContext, Indicador):ModelAndView	br.com.linkcom.sgm.service.IndicadorService
br.com.linkcom.sgm.controller.crud.OcorrenciaCrud::salvarAndEncaminhar(WebRequestContext, Ocorrencia):ModelAndView	br.com.linkcom.sgm.beans.Ocorrencia
br.com.linkcom.sgm.controller.crud.ParametrosSistemaCrud::testeemail(WebRequestContext, ParametrosSistema):ModelAndView	br.com.linkcom.sgm.service.ParametrosSistemaService
br.com.linkcom.sgm.controller.IndexController::exec(WebRequestContext):ModelAndView	br.com.linkcom.sgm.service.MensagemService
br.com.linkcom.sgm.controller.process.DefinicaoCompetenciaProcess::entrada(WebRequestContext,PlanoGestaoUnidadeGerencialFiltro):ModelAndView	br.com.linkcom.sgm.service.UsuarioService
br.com.linkcom.sgm.controller.process.DefinicaoCompetenciaProcess::salvar(WebRequestContext, UnidadeGerencial):ModelAndView	br.com.linkcom.sgm.service.MapaCompetenciaService
br.com.linkcom.sgm.controller.process.DefinicaoEstrategiaProcess::entrada(WebRequestContext, DefinicaoEstrategiaFiltro):ModelAndView	br.com.linkcom.sgm.service.UsuarioService
br.com.linkcom.sgm.controller.process.DefinicaoEstrategiaProcess::excluir(WebRequestContext, DefinicaoEstrategiaFiltro):ModelAndView	br.com.linkcom.sgm.service.MapaEstrategicoService
br.com.linkcom.sgm.controller.process.DefinicaoEstrategiaProcess::salvar(WebRequestContext, DefinicaoEstrategiaFiltro):ModelAndView	br.com.linkcom.sgm.service.MapaEstrategicoService
br.com.linkcom.sgm.controller.process.DefinicaoNegocioProcess::entrada(WebRequestContext,PlanoGestaoUnidadeGerencialFiltro):ModelAndView	br.com.linkcom.sgm.service.UsuarioService
br.com.linkcom.sgm.controller.process.DistribuicaoPesosIndicadoresProcess::configuraParametrosTela(WebRequestContext, Indicador):void	br.com.linkcom.sgm.service.UsuarioService
br.com.linkcom.sgm.controller.process.DistribuicaoPesosIndicadoresProcess::error(WebRequestContext, DistribuicaoPesosIndicadores):ModelAndView	br.com.linkcom.sgm.service.DistribuicaoPesosIndicadoresService
br.com.linkcom.sgm.controller.process.DistribuicaoPesosIndicadoresProcess::executar(WebRequestContext, DistribuicaoPesosIndicadores):ModelAndView	br.com.linkcom.sgm.beans.DistribuicaoPesosIndicadores
br.com.linkcom.sgm.controller.process.DistribuicaoPesosIndicadoresProcess::popUpConfiguraFiltro(WebRequestContext, DistribuicaoPesosIndicadores):ModelAndView	br.com.linkcom.sgm.service.PerspectivaMapaEstrategicoService
br.com.linkcom.sgm.controller.process.DistribuicaoPesosIndicadoresProcess::popUpPlanoAcao(WebRequestContext, Iniciativa):ModelAndView	br.com.linkcom.sgm.service.UsuarioService
br.com.linkcom.sgm.controller.process.DistribuicaoPesosIndicadoresProcess::salvar(WebRequestContext, DistribuicaoPesosIndicadores):ModelAndView	br.com.linkcom.sgm.service.DistribuicaoPesosIndicadoresService
br.com.linkcom.sgm.controller.process.DistribuicaoPesosIndicadoresProcess::salvarPopUpDetalhamentoIndicador(WebRequestContext, Indicador):ModelAndView	br.com.linkcom.sgm.beans.Indicador
br.com.linkcom.sgm.controller.process.DistribuicaoPesosIndicadoresProcess::salvarPopUpPlanoAcao(WebRequestContext, Iniciativa):ModelAndView	br.com.linkcom.sgm.beans.Iniciativa
br.com.linkcom.sgm.controller.process.DistribuicaoPesosIndicadoresProcess::validaForm(Indicador, WebRequestContext):boolean	br.com.linkcom.sgm.service.AnexoIndicadorService
br.com.linkcom.sgm.controller.process.EnvioEmailProcess::carregarPagina(WebRequestContext,EnvioEmailFiltro):ModelAndView	br.com.linkcom.sgm.controller.filtro.EnvioEmailFiltro
br.com.linkcom.sgm.controller.process.EnvioEmailProcess::enviarMailling(WebRequestContext,EnvioEmailFiltro):ModelAndView	br.com.linkcom.sgm.controller.filtro.EnvioEmailFiltro
br.com.linkcom.sgm.controller.process.LancamentoValorRealProcess::alternarValores(WebRequestContext, LancamentoValorRealFiltro):ModelAndView	br.com.linkcom.sgm.controller.filtro.LancamentoValorRealFiltro
br.com.linkcom.sgm.controller.process.LancamentoValorRealProcess::entrada(WebRequestContext, LancamentoValorRealFiltro):ModelAndView	br.com.linkcom.sgm.service.LancamentoValorRealService
br.com.linkcom.sgm.controller.process.SolicitacaoCancelamentoIndicadorProcess::cancelamentoPorLancamento(WebRequestContext, SolicitacaoCancelamentoIndicador):void	br.com.linkcom.sgm.beans.SolicitacaoCancelamentoIndicador
br.com.linkcom.sgm.controller.process.SolicitacaoCancelamentoIndicadorProcess::excluir(WebRequestContext, SolicitacaoCancelamentoIndicadorFiltro):ModelAndView	br.com.linkcom.sgm.controller.filtro.SolicitacaoCancelamentoIndicadorFiltro
br.com.linkcom.sgm.controller.process.SolicitacaoCancelamentoIndicadorProcess::executar(WebRequestContext, SolicitacaoCancelamentoIndicadorFiltro):ModelAndView	br.com.linkcom.sgm.service.SolicitacaoCancelamentoIndicadorService
br.com.linkcom.sgm.controller.process.SolicitacaoCancelamentoIndicadorProcess::incluirComentario(WebRequestContext, ComentarioItem):ModelAndView	br.com.linkcom.sgm.service.UsuarioService
br.com.linkcom.sgm.controller.process.SolicitacaoCancelamentoIndicadorProcess::salvar(WebRequestContext, SolicitacaoCancelamentoIndicadorFiltro):ModelAndView	br.com.linkcom.sgm.controller.filtro.SolicitacaoCancelamentoIndicadorFiltro
br.com.linkcom.sgm.controller.process.SolicitacaoRepactuacaoIndicadorProcess::excluir(WebRequestContext, SolicitacaoRepactuacaoIndicadorFiltro):ModelAndView	br.com.linkcom.sgm.controller.filtro.SolicitacaoRepactuacaoIndicadorFiltro
br.com.linkcom.sgm.controller.process.SolicitacaoRepactuacaoIndicadorProcess::executar(WebRequestContext, SolicitacaoRepactuacaoIndicadorFiltro):ModelAndView	br.com.linkcom.sgm.service.SolicitacaoRepactuacaoIndicadorService
br.com.linkcom.sgm.controller.process.SolicitacaoRepactuacaoIndicadorProcess::incluirComentario(WebRequestContext, ComentarioItem):ModelAndView	br.com.linkcom.sgm.service.UsuarioService
br.com.linkcom.sgm.controller.process.SolicitacaoRepactuacaoIndicadorProcess::repactuacaoPorLancamento(WebRequestContext, SolicitacaoRepactuacaoIndicador):void	br.com.linkcom.sgm.beans.SolicitacaoRepactuacaoIndicador
br.com.linkcom.sgm.controller.process.SolicitacaoRepactuacaoIndicadorProcess::salvar(WebRequestContext, SolicitacaoRepactuacaoIndicadorFiltro):ModelAndView	br.com.linkcom.sgm.controller.filtro.SolicitacaoRepactuacaoIndicadorFiltro
br.com.linkcom.sgm.controller.UnidadeGerencialAutoCompleteController::view(WebRequestContext, UnidadeGerencialTreeFiltro):void	br.com.linkcom.sgm.controller.filtro.UnidadeGerencialTreeFiltro
br.com.linkcom.sgm.dao.AcaoPreventivaDAO::deleteByUnidadeGerencial(UnidadeGerencial):void	br.com.linkcom.sgm.beans.UnidadeGerencial
br.com.linkcom.sgm.dao.AcompanhamentoIndicadorDAO::obtemAcompanhamentos(Indicador):List<AcompanhamentoIndicador>	br.com.linkcom.sgm.beans.Indicador
br.com.linkcom.sgm.dao.AcompanhamentoIndicadorDAO::setNullAcaoPreventiva(AcaoPreventiva):void	br.com.linkcom.sgm.beans.AcaoPreventiva
br.com.linkcom.sgm.dao.AcompanhamentoIndicadorDAO::setNullAnomalia(Anomalia):void	br.com.linkcom.sgm.beans.Anomalia
br.com.linkcom.sgm.dao.AcompanhamentoIndicadorDAO::updateAcaoPreventiva(AcompanhamentoIndicador, AcaoPreventiva):void	br.com.linkcom.sgm.beans.AcaoPreventiva
br.com.linkcom.sgm.dao.AcompanhamentoIndicadorDAO::updateAnomalia(AcompanhamentoIndicador, Anomalia):void	br.com.linkcom.sgm.beans.Anomalia
br.com.linkcom.sgm.dao.AcompanhamentoIndicadorDAO::updateValorReal(AcompanhamentoIndicador, java.lang.Double):void	br.com.linkcom.sgm.beans.AcompanhamentoIndicador
br.com.linkcom.sgm.dao.AnomaliaDAO::atualizaEnvioLembreteTratamentoAnomalia(Anomalia):void	br.com.linkcom.sgm.beans.Anomalia
br.com.linkcom.sgm.dao.AnomaliaDAO::atualizaStatusAnomalia(Anomalia, StatusAnomaliaEnum):void	br.com.linkcom.sgm.beans.Anomalia
br.com.linkcom.sgm.dao.AnomaliaDAO::deleteByUnidadeGerencial(UnidadeGerencial):void	br.com.linkcom.sgm.beans.UnidadeGerencial
br.com.linkcom.sgm.dao.AnomaliaDAO::findForReportListagemAnomalia(AnomaliaListagemReportFiltro):List<Anomalia>	br.com.linkcom.sgm.controller.report.filtro.AnomaliaListagemReportFiltro
br.com.linkcom.sgm.dao.AuditoriaGestaoDAO::deleteByUnidadeGerencial(UnidadeGerencial):void	br.com.linkcom.sgm.beans.UnidadeGerencial
br.com.linkcom.sgm.dao.IndicadorDAO::atualizaIndicador(Indicador):void	br.com.linkcom.sgm.beans.Indicador
br.com.linkcom.sgm.dao.IndicadorDAO::atualizaStatusIndicador(Indicador, StatusIndicadorEnum):void	br.com.linkcom.sgm.beans.Indicador
br.com.linkcom.sgm.dao.IndicadorDAO::deleteByUnidadeGerencial(UnidadeGerencial):void	br.com.linkcom.sgm.beans.UnidadeGerencial
br.com.linkcom.sgm.dao.IndicadorDAO::deleteWhereNotIn(UnidadeGerencial, ObjetivoMapaEstrategico, String):void	br.com.linkcom.sgm.beans.ObjetivoMapaEstrategico
br.com.linkcom.sgm.dao.IniciativaDAO::atualizaIniciativa(Iniciativa):void	br.com.linkcom.sgm.beans.Iniciativa
br.com.linkcom.sgm.dao.IniciativaDAO::deleteByUnidadeGerencial(UnidadeGerencial):void	br.com.linkcom.sgm.beans.UnidadeGerencial
br.com.linkcom.sgm.dao.IniciativaDAO::deleteWhereNotIn(UnidadeGerencial, ObjetivoMapaEstrategico, String):void	br.com.linkcom.sgm.beans.ObjetivoMapaEstrategico
br.com.linkcom.sgm.dao.IniciativaDAO::findByUnidadeGerencial(UnidadeGerencial):List<Iniciativa>	br.com.linkcom.sgm.beans.UnidadeGerencial
br.com.linkcom.sgm.dao.MatrizFCSDAO::deleteByUnidadeGerencial(UnidadeGerencial):void	br.com.linkcom.sgm.beans.UnidadeGerencial
br.com.linkcom.sgm.dao.MatrizFCSDAO::findWithEstrategiasByUnidadeGerencial(UnidadeGerencial):List<MatrizFCS>	br.com.linkcom.sgm.beans.UnidadeGerencial
br.com.linkcom.sgm.dao.MatrizFCSIniciativaDAO::findPrioritariasByUnidadeGerencial(UnidadeGerencial):List<MatrizFCSIniciativa>	br.com.linkcom.sgm.beans.UnidadeGerencial
br.com.linkcom.sgm.dao.OcorrenciaDAO::deleteByUnidadeGerencial(UnidadeGerencial):void	br.com.linkcom.sgm.beans.UnidadeGerencial
br.com.linkcom.sgm.dao.OcorrenciaDAO::setNullAnomalia(Anomalia):void	br.com.linkcom.sgm.beans.Anomalia
br.com.linkcom.sgm.dao.PainelIndicadorFiltroDAO::deleteByUnidadeGerencial(UnidadeGerencial):void	br.com.linkcom.sgm.beans.UnidadeGerencial
br.com.linkcom.sgm.dao.PainelIndicadorFiltroDAO::findByUnidadeGerencial(UnidadeGerencial):List<PainelIndicadorFiltro>	br.com.linkcom.sgm.beans.UnidadeGerencial
br.com.linkcom.sgm.dao.PlanoAcaoDAO::deleteByUnidadeGerencial(UnidadeGerencial):void	br.com.linkcom.sgm.beans.UnidadeGerencial
br.com.linkcom.sgm.dao.PlanoAcaoDAO::findByIniciativas(IniciativaPlanoAcaoFiltro):List<PlanoAcao>	br.com.linkcom.sgm.controller.filtro.IniciativaPlanoAcaoFiltro
br.com.linkcom.sgm.dao.SolicitacaoCancelamentoIndicadorDAO::existeSolicitacaoCancelamentoAberta(Indicador):Boolean	br.com.linkcom.sgm.beans.Indicador
br.com.linkcom.sgm.dao.SolicitacaoCancelamentoIndicadorDAO::findSolicitacoes(SolicitacaoCancelamentoIndicadorFiltro):List<SolicitacaoCancelamentoIndicador>	br.com.linkcom.sgm.controller.filtro.SolicitacaoCancelamentoIndicadorFiltro
br.com.linkcom.sgm.dao.SolicitacaoCancelamentoIndicadorDAO::saveOrUpdateStatus(SolicitacaoCancelamentoIndicador):void	br.com.linkcom.sgm.beans.SolicitacaoCancelamentoIndicador
br.com.linkcom.sgm.dao.SolicitacaoRepactuacaoIndicadorDAO::existeSolicitacaoRepactuacaoAberta(Indicador):Boolean	br.com.linkcom.sgm.beans.Indicador
br.com.linkcom.sgm.dao.SolicitacaoRepactuacaoIndicadorDAO::findSolicitacoes(SolicitacaoRepactuacaoIndicadorFiltro):List<SolicitacaoRepactuacaoIndicador>	br.com.linkcom.sgm.controller.filtro.SolicitacaoRepactuacaoIndicadorFiltro
br.com.linkcom.sgm.dao.SolicitacaoRepactuacaoIndicadorDAO::saveOrUpdateStatus(SolicitacaoRepactuacaoIndicador):void	br.com.linkcom.sgm.beans.SolicitacaoRepactuacaoIndicador
br.com.linkcom.sgm.dao.UnidadeGerencialDAO::findNodosRaiz(PlanoGestao):List<UnidadeGerencial>	br.com.linkcom.sgm.beans.PlanoGestao
br.com.linkcom.sgm.dao.UnidadeGerencialDAO::getProximoSequencialAcaoPreventiva(UnidadeGerencial):int	br.com.linkcom.sgm.beans.UnidadeGerencial
br.com.linkcom.sgm.dao.UnidadeGerencialDAO::getProximoSequencialAnomalia(UnidadeGerencial, int):int	br.com.linkcom.sgm.beans.UnidadeGerencial
br.com.linkcom.sgm.dao.UnidadeGerencialDAO::getProximoSequencialOcorrencia(UnidadeGerencial):int	br.com.linkcom.sgm.beans.UnidadeGerencial
br.com.linkcom.sgm.dao.UsuarioDAO::updatePassword(Usuario):void	br.com.linkcom.sgm.beans.Usuario
br.com.linkcom.sgm.quartzjobs.EnviaEmailLembreteLancamentoResultadosJOB::envia(String, Usuario, StringBuilder):boolean	br.com.linkcom.sgm.beans.Usuario
br.com.linkcom.sgm.quartzjobs.EnviaEmailLembreteTratamentoAnomaliaJOB::envia(String, Usuario, StringBuilder):boolean	br.com.linkcom.sgm.beans.Usuario
br.com.linkcom.sgm.report.bean.ApresentacaoResultadosReportBean::getDataFinal():String	br.com.linkcom.sgm.beans.DTO.ApresentacaoResultadosDTO
br.com.linkcom.sgm.report.bean.ApresentacaoResultadosReportBean::getDataInicial():String	br.com.linkcom.sgm.beans.DTO.ApresentacaoResultadosDTO
br.com.linkcom.sgm.report.bean.ApresentacaoResultadosReportBean::getGraficoApresentacao():String	br.com.linkcom.sgm.beans.DTO.ApresentacaoResultadosDTO
br.com.linkcom.sgm.report.bean.ApresentacaoResultadosReportBean::getGraficoTipo():String	br.com.linkcom.sgm.beans.DTO.ApresentacaoResultadosDTO
br.com.linkcom.sgm.report.bean.ApresentacaoResultadosReportBean::getGraficoTipoResultado():String	br.com.linkcom.sgm.beans.DTO.ApresentacaoResultadosDTO
br.com.linkcom.sgm.senha.process.AlterarSenhaProcess::salvar(WebRequestContext, br.com.linkcom.sgm.filtro.AlterarSenhaFiltro):ModelAndView	br.com.linkcom.sgm.filtro.AlterarSenhaFiltro
br.com.linkcom.sgm.service.AnomaliaService::calculaLocalAnomalia(Anomalia):br.com.linkcom.sgm.beans.enumeration.LocalAnomaliaEnum	br.com.linkcom.sgm.dao.AnomaliaDAO
br.com.linkcom.sgm.service.AnomaliaService::createAnomaliaListagemReport(AnomaliaListagemReportFiltro):IReport	br.com.linkcom.sgm.controller.report.filtro.AnomaliaListagemReportFiltro
br.com.linkcom.sgm.service.AnomaliaService::createAnomaliaSinteticoPorStatusReport(AnomaliaSinteticoPorStatusReportFiltro):IReport	br.com.linkcom.sgm.controller.report.filtro.AnomaliaSinteticoPorStatusReportFiltro
br.com.linkcom.sgm.service.AnomaliaService::enviaEmailNotificacaoCumprimentoPendente(Anomalia):void	br.com.linkcom.sgm.beans.Anomalia
br.com.linkcom.sgm.service.AnomaliaService::enviaEmailSolicitacaoEncerramento(Anomalia):void	br.com.linkcom.sgm.beans.Anomalia
br.com.linkcom.sgm.service.AnomaliaService::loadParent(Anomalia):Anomalia	br.com.linkcom.sgm.service.PlanoAcaoService
br.com.linkcom.sgm.service.AuditoriaInternaService::enviaEmailSolicitacaoEncerramento(AuditoriaInterna):void	br.com.linkcom.sgm.beans.AuditoriaInterna
br.com.linkcom.sgm.service.CausaEfeitoService::excluirCausaEfeito(Anomalia):void	br.com.linkcom.sgm.dao.CausaEfeitoDAO
br.com.linkcom.sgm.service.CausaEfeitoService::preencheListaCausaEfeito(Anomalia):List<CausaEfeito>	br.com.linkcom.sgm.dao.CausaEfeitoDAO
br.com.linkcom.sgm.service.CausaEfeitoService::salvarCausaEfeito(Anomalia):void	br.com.linkcom.sgm.dao.CausaEfeitoDAO
br.com.linkcom.sgm.service.ControleCadastroService::montaItemControleCadastroMapaCompetencia(UnidadeGerencial, HttpServletRequest):ControleCadastroItem	br.com.linkcom.sgm.beans.UnidadeGerencial
br.com.linkcom.sgm.service.DistribuicaoPesosIndicadoresService::salvar(DistribuicaoPesosIndicadores):void	br.com.linkcom.sgm.service.IniciativaService
br.com.linkcom.sgm.service.DistribuicaoPesosIndicadoresService::usuarioPodeAlterar(Boolean, Boolean, PlanoGestao):Boolean	br.com.linkcom.sgm.service.PlanoGestaoService
br.com.linkcom.sgm.service.IndicadorService::agruparPorFator(Indicador, int, List<Calendar>):List<AcompanhamentoIndicador>	br.com.linkcom.sgm.beans.Indicador
br.com.linkcom.sgm.service.IndicadorService::atualizaIndicadores(List<Indicador>, UnidadeGerencial, ObjetivoMapaEstrategico):void	br.com.linkcom.sgm.dao.IndicadorDAO
br.com.linkcom.sgm.service.IndicadorService::copiaIndicador(UnidadeGerencial, ObjetivoMapaEstrategico, Indicador, boolean):void	br.com.linkcom.sgm.service.AnexoIndicadorService
br.com.linkcom.sgm.service.IndicadorService::createReportApresentacaoResultados(ApresentacaoResultadosDTO):IReport	br.com.linkcom.sgm.beans.DTO.ApresentacaoResultadosDTO
br.com.linkcom.sgm.service.IndicadorService::createReportPendenciaAnomalia(PendenciaAnomaliaReportFiltro):IReport	br.com.linkcom.sgm.dao.IndicadorDAO
br.com.linkcom.sgm.service.IndicadorService::criarRelatorioIndicadoresEstrategico(ndicadoresEstrategicoReportFiltro):IReport	br.com.linkcom.sgm.dao.IndicadorDAO
br.com.linkcom.sgm.service.IndicadorService::dataLimiteCriacaoNaoExpirada(Indicador):boolean	br.com.linkcom.sgm.service.PlanoGestaoService
br.com.linkcom.sgm.service.IndicadorService::obtemSomatorioColecaoAcompanhamento(Indicador,Calendar,Calendar):Indicador	br.com.linkcom.sgm.service.AcompanhamentoIndicadorService
br.com.linkcom.sgm.service.IniciativaService::atualizaIniciativaListaPlanoAcaoDaIniciativa(UnidadeGerencial, ObjetivoMapaEstrategico, Iniciativa):void	br.com.linkcom.sgm.service.PlanoAcaoService
br.com.linkcom.sgm.service.LancamentoValorRealService::pesquisar(LancamentoValorRealFiltro):LancamentoValorRealFiltro	br.com.linkcom.sgm.service.PerspectivaMapaEstrategicoService
br.com.linkcom.sgm.service.LancamentoValorRealService::showBotaoSalvar(LancamentoValorRealFiltro):Boolean	br.com.linkcom.sgm.controller.filtro.LancamentoValorRealFiltro
br.com.linkcom.sgm.service.MapaEstrategicoService::excluiMapaEstrategico(MapaEstrategico):void	br.com.linkcom.sgm.beans.MapaEstrategico
br.com.linkcom.sgm.service.MapaEstrategicoService::salvaDefinicaoObjetivoEstrategico(MapaEstrategico, UnidadeGerencial, boolean):void	br.com.linkcom.sgm.service.PerspectivaMapaEstrategicoService
br.com.linkcom.sgm.service.MatrizFCSService::createMatrizFCSReport(MatrizFCSReportFiltro):IReport	br.com.linkcom.sgm.service.UsuarioService
br.com.linkcom.sgm.service.MensagemService::listaVisiveisMensagemService():List<Mensagem>	br.com.linkcom.sgm.dao.MensagemDAO
br.com.linkcom.sgm.service.ObjetivoMapaEstrategicoService::createDesempenhoReport(DesempenhoReportFiltro):IReport	br.com.linkcom.sgm.controller.report.filtro.DesempenhoReportFiltro
br.com.linkcom.sgm.service.ObjetivoMapaEstrategicoService::findByUnidadeGerencialPerspectivaThroughMatrizFCS(UnidadeGerencial,PerspectivaMapaEstrategico, boolean, boolean, boolean, boolean, boolean):List<ObjetivoMapaEstrategico>	br.com.linkcom.sgm.dao.ObjetivoMapaEstrategicoDAO
br.com.linkcom.sgm.service.ObjetivoMapaEstrategicoService::findByUnidadeGerencialThroughMapaEstrategico(UnidadeGerencial, boolean):List<ObjetivoMapaEstrategico>	br.com.linkcom.sgm.dao.ObjetivoMapaEstrategicoDAO
br.com.linkcom.sgm.service.ObjetivoMapaEstrategicoService::findByUnidadeGerencialThroughMatrizFCS(UnidadeGerencial, boolean):List<ObjetivoMapaEstrategico>	br.com.linkcom.sgm.dao.ObjetivoMapaEstrategicoDAO
br.com.linkcom.sgm.service.OcorrenciaService::createReportDiarioBordo(br.com.linkcom.sgm.filtro.OcorrenciaFiltro):IReport	br.com.linkcom.sgm.dao.OcorrenciaDAO
br.com.linkcom.sgm.service.PerspectivaMapaEstrategicoService::findByMapaEstrategico(MapaEstrategico):List<PerspectivaMapaEstrategico>	br.com.linkcom.sgm.beans.MapaEstrategico
br.com.linkcom.sgm.service.PerspectivaMapaEstrategicoService::findByUnidadeGerencialThroughMapaEstrategico(UnidadeGerencial, boolean, String):List<PerspectivaMapaEstrategico>	br.com.linkcom.sgm.dao.PerspectivaMapaEstrategicoDAO
br.com.linkcom.sgm.service.PerspectivaMapaEstrategicoService::findByUnidadeGerencialThroughMatrizFCS(UnidadeGerencial, boolean):List<PerspectivaMapaEstrategico>	br.com.linkcom.sgm.dao.PerspectivaMapaEstrategicoDAO
br.com.linkcom.sgm.service.PlanoAcaoService::createIniciativaPlanoAcaoReport(IniciativaPlanoAcaoFiltro):IReport	br.com.linkcom.sgm.controller.filtro.IniciativaPlanoAcaoFiltro
br.com.linkcom.sgm.service.PlanoAcaoService::findByIniciativas(IniciativaPlanoAcaoFiltro):List<PlanoAcao>	br.com.linkcom.sgm.service.UsuarioService
br.com.linkcom.sgm.service.PlanoGestaoService::copiaPlanoGestao(PlanoGestao, PlanoGestao):void	br.com.linkcom.sgm.service.MapaEstrategicoService
br.com.linkcom.sgm.service.SolicitacaoCancelamentoIndicadorService::findSolicitacoes(SolicitacaoCancelamentoIndicadorFiltro):List<SolicitacaoCancelamentoIndicador>	br.com.linkcom.sgm.service.UsuarioService
br.com.linkcom.sgm.service.SolicitacaoRepactuacaoIndicadorService::findSolicitacoes(SolicitacaoRepactuacaoIndicadorFiltro):List<SolicitacaoRepactuacaoIndicador>	br.com.linkcom.sgm.service.UsuarioService
br.com.linkcom.sgm.service.UnidadeGerencialService::findAllParents(UnidadeGerencial):List<UnidadeGerencial>	br.com.linkcom.sgm.dao.UnidadeGerencialDAO
br.com.linkcom.sgm.service.UnidadeGerencialService::loadUGObjetivoEstrategicoIndicadorAcompanhamento(PlanoGestao, UnidadeGerencial, boolean):List<UnidadeGerencial>	br.com.linkcom.sgm.service.PerspectivaMapaEstrategicoService
br.com.linkcom.sgm.service.UnidadeGerencialService::montaListaDescricaoUnidadeGerencialComDescendencia(UnidadeGerencial, List<String>):List<String>	br.com.linkcom.sgm.dao.UnidadeGerencialDAO
br.com.linkcom.sgm.service.UnidadeGerencialService::montaListaUnidadeGerencial(PlanoGestao, UnidadeGerencial, boolean):List<UnidadeGerencial>	br.com.linkcom.sgm.service.UsuarioService
br.com.linkcom.sgm.service.UsuarioService::getUsuarioLogadoUGs(PlanoGestao):List<UnidadeGerencial>	br.com.linkcom.sgm.beans.PlanoGestao
br.com.linkcom.sgm.service.UsuarioService::isUsuarioLogadoVinculadoAreaAuditoriaInterna(PlanoGestao):Boolean	br.com.linkcom.sgm.beans.PlanoGestao
br.com.linkcom.sgm.service.UsuarioService::isUsuarioLogadoVinculadoAreaQualidade(PlanoGestao):Boolean	br.com.linkcom.sgm.beans.PlanoGestao
br.com.linkcom.sgm.util.email.EnviaEmailTeste::enviaEmail(HttpServletRequest, ParametrosSistema):String	br.com.linkcom.sgm.beans.ParametrosSistema
br.com.linkcom.sgm.controller.crud.AnomaliaCrud::exibirBotaoSolicitarReanalise(Anomalia, Boolean, Boolean):Boolean	br.com.linkcom.sgm.beans.Anomalia
br.com.linkcom.sgm.controller.process.MatrizFCSProcess::salvar(WebRequestContext, MatrizFCSFiltro):ModelAndView	br.com.linkcom.sgm.service.MatrizFCSService
br.com.linkcom.sgm.service.AcompanhamentoIndicadorService::updateValorBase(Indicador):void	br.com.linkcom.sgm.beans.Indicador
br.com.linkcom.sgm.service.AnomaliaService::deleteByUnidadeGerencial(UnidadeGerencial):void	br.com.linkcom.sgm.dao.AnomaliaDAO
br.com.linkcom.sgm.service.AnomaliaService::gerarMensagemEmailAnomalia(Anomalia):String	br.com.linkcom.sgm.beans.Anomalia
br.com.linkcom.sgm.service.AnomaliaService::getDataLimiteParaTratamento(Anomalia, int):java.sql.Date	br.com.linkcom.sgm.beans.Anomalia
br.com.linkcom.sgm.service.AnomaliaService::getStatusAnomalia(Anomalia, int, int):StatusAnomaliaEnum	br.com.linkcom.sgm.beans.Anomalia
br.com.linkcom.sgm.service.AnomaliaService::getStatusTratamentoAnomalia(Anomalia):StatusTratamentoAnomaliaEnum	br.com.linkcom.sgm.beans.Anomalia
br.com.linkcom.sgm.service.AnomaliaService::isAnomaliaTratada(Anomalia):Boolean	br.com.linkcom.sgm.beans.Anomalia
br.com.linkcom.sgm.service.AnomaliaService::isDataEncerramentoAnomaliaExpirada(Anomalia, int):Boolean	br.com.linkcom.sgm.beans.Anomalia
br.com.linkcom.sgm.service.AnomaliaService::isDataLembreteTratamentoAnomaliaAtingida(Anomalia, int):Boolean	br.com.linkcom.sgm.beans.Anomalia
br.com.linkcom.sgm.service.AnomaliaService::isDataTravamentoAnomaliaExpirada(Anomalia, int):Boolean	br.com.linkcom.sgm.beans.Anomalia
br.com.linkcom.sgm.service.AuditoriaInternaService::deleteByUnidadeGerencial(UnidadeGerencial):void	br.com.linkcom.sgm.dao.AuditoriaInternaDAO
br.com.linkcom.sgm.service.ControleCadastroService::montaItemControleCadastroMapaEstrategico(UnidadeGerencial, HttpServletRequest):ControleCadastroItem	br.com.linkcom.sgm.beans.UnidadeGerencial
br.com.linkcom.sgm.service.ControleCadastroService::montaItemControleCadastroMapaNegocio(UnidadeGerencial, HttpServletRequest):ControleCadastroItem	br.com.linkcom.sgm.beans.UnidadeGerencial
br.com.linkcom.sgm.service.ControleCadastroService::montaItemControleCadastroMatrizFCS(UnidadeGerencial, HttpServletRequest):ControleCadastroItem	br.com.linkcom.sgm.beans.UnidadeGerencial
br.com.linkcom.sgm.service.ControleCadastroService::montaItemControleTratamentoAnomlia(Anomalia, HttpServletRequest):ControleCadastroItem	br.com.linkcom.sgm.beans.Anomalia
br.com.linkcom.sgm.service.IndicadorService::usuarioPodeAlterar(Indicador):boolean	br.com.linkcom.sgm.service.UsuarioService
br.com.linkcom.sgm.service.IniciativaService::atualizaIniciativas(List<Iniciativa>, UnidadeGerencial, ObjetivoMapaEstrategico):void	br.com.linkcom.sgm.dao.IniciativaDAO
br.com.linkcom.sgm.service.OcorrenciaService::podeAlterar(Ocorrencia):Boolean	br.com.linkcom.sgm.service.UsuarioService
br.com.linkcom.sgm.service.PlanoAcaoService::findByAcaoPreventivaPlanoAcaoService(AcaoPreventiva):List<PlanoAcao>	br.com.linkcom.sgm.dao.PlanoAcaoDAO
br.com.linkcom.sgm.service.PlanoAcaoService::findByAnomaliaPlanoAcaoService(Anomalia):List<PlanoAcao>	br.com.linkcom.sgm.dao.PlanoAcaoDAO
br.com.linkcom.sgm.service.PlanoAcaoService::findByUGIniciativaPlanoAcaoService(UnidadeGerencial, Iniciativa):List<PlanoAcao>	br.com.linkcom.sgm.dao.PlanoAcaoDAO
br.com.linkcom.sgm.service.PlanoGestaoService::isDtLimLancResultadosExpirada(PlanoGestao, java.lang.Integer):Boolean	br.com.linkcom.sgm.beans.PlanoGestao
br.com.linkcom.sgm.service.PlanoGestaoService::isDtTravLancResultadosExpirada(PlanoGestao, java.lang.Integer):Boolean	br.com.linkcom.sgm.beans.PlanoGestao
br.com.linkcom.sgm.service.RequisitoNormaService::findByNormaRequisitoNormaService(Norma):List<RequisitoNorma>	br.com.linkcom.sgm.dao.RequisitoNormaDAO
br.com.linkcom.sgm.service.UsuarioService::encryptPassword(Usuario):Usuario	br.com.linkcom.sgm.beans.Usuario
br.com.linkcom.sgm.service.UsuarioService::updatePassword(Usuario, boolean):void	br.com.linkcom.sgm.dao.UsuarioDAO
br.com.linkcom.sgm.controller.crud.AcaoPreventivaCrud::usuarioPodeEditarAcaoPreventiva(AcaoPreventiva, Boolean, Boolean):Boolean	br.com.linkcom.sgm.beans.AcaoPreventiva
br.com.linkcom.sgm.controller.crud.AnomaliaCrud::exibirBotaoNotificarCumprimentoPendente(Anomalia, Boolean):Boolean	br.com.linkcom.sgm.beans.Anomalia
br.com.linkcom.sgm.controller.crud.AnomaliaCrud::exibirBotaoSolicitarEncerramento(Anomalia, Boolean,Boolean):Boolean	br.com.linkcom.sgm.beans.Anomalia
br.com.linkcom.sgm.controller.crud.AnomaliaCrud::usuarioPodeConsultarAnomalia(Anomalia, Boolean, Boolean, Boolean, Boolean):Boolean	br.com.linkcom.sgm.beans.Anomalia
br.com.linkcom.sgm.controller.crud.AnomaliaCrud::usuarioPodeCriarPlanoAcao(Anomalia, Boolean, Boolean, Boolean):Boolean	br.com.linkcom.sgm.beans.Anomalia
br.com.linkcom.sgm.controller.crud.AnomaliaCrud::usuarioPodeDestravarAnomalia(Anomalia, Boolean, Boolean, Boolean):Boolean	br.com.linkcom.sgm.beans.Anomalia
br.com.linkcom.sgm.controller.crud.AnomaliaCrud::usuarioPodeEditarAnomalia(Anomalia, Boolean, Boolean):Boolean	br.com.linkcom.sgm.beans.Anomalia
br.com.linkcom.sgm.controller.crud.AnomaliaCrud::usuarioPodeEncerrarAnomalia(Anomalia, Boolean, Boolean):Boolean	br.com.linkcom.sgm.beans.Anomalia
br.com.linkcom.sgm.controller.crud.AnomaliaCrud::usuarioPodeTratarAnomalia(Anomalia, Boolean, Boolean, Boolean):Boolean	br.com.linkcom.sgm.beans.Anomalia
br.com.linkcom.sgm.controller.crud.AuditoriaInternaCrud::usuarioPodeEditarAuditoriaInterna(AuditoriaInterna, Boolean, Boolean, Boolean):Boolean	br.com.linkcom.sgm.beans.AuditoriaInterna
br.com.linkcom.sgm.service.AcompanhamentoIndicadorService::getListaDataAcompanhamentoIndicador(List<Indicador>,Calendar,Calendar):List<Calendar>	br.com.linkcom.sgm.dao.AcompanhamentoIndicadorDAO
br.com.linkcom.sgm.service.AnexoAnomaliaService::excluiAnexoAnomaliaDetalhe(Anomalia):void	br.com.linkcom.sgm.dao.AnexoAnomaliaDAO
br.com.linkcom.sgm.service.AnexoIndicadorService::excluiAnexoIndicadorDetalhe(Indicador):void	br.com.linkcom.sgm.dao.AnexoIndicadorDAO
br.com.linkcom.sgm.service.IndicadorService::calculaAcompanhamentosIndicador(Indicador, List<Calendar>):Indicador	br.com.linkcom.sgm.beans.Indicador
br.com.linkcom.sgm.service.IndicadorService::obtemFrequenciaIndicadorService(Indicador):Indicador	br.com.linkcom.sgm.dao.IndicadorDAO
br.com.linkcom.sgm.service.ObjetivoMapaEstrategicoService::findByUnidadeGerencialPerspectivaThroughMapaEstrategico(UnidadeGerencial,PerspectivaMapaEstrategico, boolean, boolean, boolean, boolean, boolean, String):List<ObjetivoMapaEstrategico>	br.com.linkcom.sgm.dao.ObjetivoMapaEstrategicoDAO
br.com.linkcom.sgm.service.UsuarioPapelService::getPapeis(Usuario):java.util.Set<Papel>	br.com.linkcom.sgm.dao.UsuarioPapelDAO
br.com.linkcom.sgm.service.UsuarioUnidadeGerencialService::findUsuariosQualidadeEnvolvidoAnomalia(PlanoGestao):List<UsuarioUnidadeGerencial>	br.com.linkcom.sgm.dao.UsuarioUnidadeGerencialDAO
br.com.linkcom.sgm.controller.crud.AcaoPreventivaCrud::usuarioPodeConsultarAcaoPreventiva(AcaoPreventiva, Boolean, Boolean, Boolean):Boolean	br.com.linkcom.sgm.beans.AcaoPreventiva
br.com.linkcom.sgm.controller.process.DistribuicaoPesosIndicadoresProcess::resolveAcompanhamentos(PlanoGestao, Indicador):void	br.com.linkcom.sgm.beans.PlanoGestao
br.com.linkcom.sgm.service.AnomaliaService::findUsuariosQualidadeEnvolvidosAnomalia(Anomalia):List<Usuario>	br.com.linkcom.sgm.service.UsuarioService
br.com.linkcom.sgm.service.IndicadorService::defineDatas(ApresentacaoResultadosDTO):void	br.com.linkcom.sgm.beans.DTO.ApresentacaoResultadosDTO
br.com.linkcom.sgm.service.LancamentoValorRealService::configuraEdicaoAcompanhamentos(LancamentoValorRealFiltro, Boolean, Boolean, Boolean):void	br.com.linkcom.sgm.service.AcompanhamentoIndicadorService
br.com.linkcom.sgm.service.LancamentoValorRealService::configuraExibicaoAcompanhamentos(LancamentoValorRealFiltro):void	br.com.linkcom.sgm.service.AcompanhamentoIndicadorService
br.com.linkcom.sgm.controller.process.DistribuicaoPesosIndicadoresProcess::isAdministradoOuDataLimiteNaoExpirada(Indicador):boolean	br.com.linkcom.sgm.service.IndicadorService
br.com.linkcom.sgm.service.AcaoPreventivaService::getStatusAcaoPreventiva(AcaoPreventiva):StatusAcaoPreventivaEnum	br.com.linkcom.sgm.beans.AcaoPreventiva
br.com.linkcom.sgm.service.AcompanhamentoIndicadorService::verificaMelhorIndicador(AcompanhamentoIndicador):Boolean	br.com.linkcom.sgm.beans.AcompanhamentoIndicador
br.com.linkcom.sgm.service.DistribuicaoPesosIndicadoresService::carregaElementosPainelIndicador(UnidadeGerencial):List<PerspectivaMapaEstrategico>	br.com.linkcom.sgm.service.PerspectivaMapaEstrategicoService
br.com.linkcom.sgm.service.DistribuicaoPesosIndicadoresService::obtemListaPerspectivaObjetivoEstrategicoIniciativaIndicador(UnidadeGerencial, boolean, boolean, boolean):List<PerspectivaMapaEstrategico>	br.com.linkcom.sgm.service.PerspectivaMapaEstrategicoService
br.com.linkcom.sgm.service.PlanoGestaoService::createReportPendenciaCadastro(PlanoGestao, List<UnidadeGerencial>):IReport	br.com.linkcom.sgm.service.ControleCadastroService
