org.jfree.data.RangeType::autoAdjustRange2(org.jfree.chart.axis.NumberAxis):void	org.jfree.chart.axis.NumberAxis
org.jfree.chart.plot.PlotState::draw2(java.awt.Graphics2D, java.awt.geom.Rectangle2D, java.awt.geom.Point2D, org.jfree.chart.plot.dial.DialPlot, org.jfree.chart.plot.PlotRenderingInfo):void	org.jfree.chart.plot.dial.DialPlot
org.jfree.chart.LegendItemCollection::drawDomainMarkers(org.jfree.chart.plot.XYPlot, java.awt.Graphics2D, java.awt.geom.Rectangle2D, int, org.jfree.ui.Layer):void	org.jfree.chart.plot.XYPlot
org.jfree.chart.StandardChartTheme::applyToAbstractRenderer(org.jfree.chart.renderer.AbstractRenderer):void	org.jfree.chart.renderer.AbstractRenderer
org.jfree.chart.ChartRenderingInfo::doSaveAs(org.jfree.experimental.chart.swt.ChartComposite):void	org.jfree.experimental.chart.swt.ChartComposite
org.jfree.chart.axis.DateAxis::calculateDateForPosition(org.jfree.data.time.RegularTimePeriod, org.jfree.chart.axis.DateTickMarkPosition):java.util.Date	org.jfree.data.time.RegularTimePeriod
org.jfree.chart.renderer.OutlierListCollection::updateOutlierList(org.jfree.chart.renderer.OutlierList, org.jfree.chart.renderer.Outlier):boolean	org.jfree.chart.renderer.OutlierList
org.jfree.chart.plot.CategoryPlot::drawRangeCrosshair(java.awt.Graphics2D, java.awt.geom.Rectangle2D, org.jfree.chart.plot.PlotOrientation, double, org.jfree.chart.axis.ValueAxis, java.awt.Stroke, java.awt.Paint):void	org.jfree.chart.axis.ValueAxis
org.jfree.chart.plot.ContourPlot::drawDomainMarker(java.awt.Graphics2D, org.jfree.chart.plot.ContourPlot, org.jfree.chart.axis.ValueAxis, org.jfree.chart.plot.Marker, java.awt.geom.Rectangle2D):void	org.jfree.chart.axis.ValueAxis
org.jfree.chart.plot.ContourPlot::drawRangeMarker(java.awt.Graphics2D, org.jfree.chart.plot.ContourPlot, org.jfree.chart.axis.ValueAxis, org.jfree.chart.plot.Marker, java.awt.geom.Rectangle2D):void	org.jfree.chart.axis.ValueAxis
org.jfree.chart.plot.XYPlot::drawDomainCrosshair(java.awt.Graphics2D, java.awt.geom.Rectangle2D, org.jfree.chart.plot.PlotOrientation, double, org.jfree.chart.axis.ValueAxis, java.awt.Stroke, java.awt.Paint):void	org.jfree.chart.axis.ValueAxis
org.jfree.chart.plot.XYPlot::drawRangeCrosshair(java.awt.Graphics2D, java.awt.geom.Rectangle2D, org.jfree.chart.plot.PlotOrientation, double, org.jfree.chart.axis.ValueAxis, java.awt.Stroke, java.awt.Paint):void	org.jfree.chart.axis.ValueAxis
org.jfree.chart.renderer.category.AbstractCategoryItemRenderer::drawRangeLine(java.awt.Graphics2D, org.jfree.chart.plot.CategoryPlot, org.jfree.chart.axis.ValueAxis, java.awt.geom.Rectangle2D, double, java.awt.Paint, java.awt.Stroke):void	org.jfree.chart.axis.ValueAxis
org.jfree.chart.renderer.category.AbstractCategoryItemRenderer::drawRangeLine(java.awt.Graphics2D, org.jfree.chart.plot.CategoryPlot, org.jfree.chart.axis.ValueAxis, java.awt.geom.Rectangle2D, double, java.awt.Paint, java.awt.Stroke):void	org.jfree.chart.plot.CategoryPlot
org.jfree.chart.renderer.xy.AbstractXYItemRenderer::drawDomainLine(java.awt.Graphics2D, org.jfree.chart.plot.XYPlot, org.jfree.chart.axis.ValueAxis, java.awt.geom.Rectangle2D, double, java.awt.Paint, java.awt.Stroke):void	org.jfree.chart.axis.ValueAxis
org.jfree.chart.renderer.xy.AbstractXYItemRenderer::drawDomainLine(java.awt.Graphics2D, org.jfree.chart.plot.XYPlot, org.jfree.chart.axis.ValueAxis, java.awt.geom.Rectangle2D, double, java.awt.Paint, java.awt.Stroke):void	org.jfree.chart.plot.XYPlot
org.jfree.chart.block.CenterArrangement::arrangeFN(org.jfree.chart.block.BlockContainer, java.awt.Graphics2D, org.jfree.chart.block.RectangleConstraint):org.jfree.ui.Size2D	org.jfree.chart.block.BlockContainer
org.jfree.chart.block.CenterArrangement::arrangeFN(org.jfree.chart.block.BlockContainer, java.awt.Graphics2D, org.jfree.chart.block.RectangleConstraint):org.jfree.ui.Size2D	org.jfree.chart.block.RectangleConstraint
org.jfree.chart.block.CenterArrangement::arrangeNN(org.jfree.chart.block.BlockContainer, java.awt.Graphics2D):org.jfree.ui.Size2D	org.jfree.chart.block.BlockContainer
org.jfree.chart.renderer.category.CategoryStepRenderer::drawLine(java.awt.Graphics2D, org.jfree.chart.renderer.category.CategoryStepRenderer.State, org.jfree.chart.plot.PlotOrientation, double, double, double, double):void	org.jfree.chart.renderer.category.CategoryStepRenderer.State
org.jfree.chart.renderer.category.BarRenderer::calculateSeriesWidth(double, org.jfree.chart.axis.CategoryAxis, int, int):double	org.jfree.chart.axis.CategoryAxis
org.jfree.chart.renderer.category.LevelRenderer::calculateSeriesWidth(double, org.jfree.chart.axis.CategoryAxis, int, int):double	org.jfree.chart.axis.CategoryAxis
org.jfree.chart.renderer.xy.AbstractXYItemRenderer::updateCrosshairValues(org.jfree.chart.plot.CrosshairState, double, double, int, int, double, double, org.jfree.chart.plot.PlotOrientation):void	org.jfree.chart.plot.CrosshairState
org.jfree.chart.renderer.xy.XYItemRendererState::drawPrimaryLine2(org.jfree.experimental.chart.renderer.xy.XYSmoothLineAndShapeRenderer, java.awt.Graphics2D, org.jfree.chart.plot.XYPlot, org.jfree.data.xy.XYDataset, int, int, int, org.jfree.chart.axis.ValueAxis, org.jfree.chart.axis.ValueAxis, java.awt.geom.Rectangle2D):void	org.jfree.chart.plot.XYPlot
org.jfree.chart.renderer.xy.XYLineAndShapeRenderer::drawPrimaryLine(org.jfree.chart.renderer.xy.XYItemRendererState, java.awt.Graphics2D, org.jfree.chart.plot.XYPlot, org.jfree.data.xy.XYDataset, int, int, int, org.jfree.chart.axis.ValueAxis, org.jfree.chart.axis.ValueAxis, java.awt.geom.Rectangle2D):void	org.jfree.chart.plot.XYPlot
org.jfree.chart.renderer.xy.XYLineAndShapeRenderer::drawPrimaryLineAsPath(org.jfree.chart.renderer.xy.XYItemRendererState, java.awt.Graphics2D, org.jfree.chart.plot.XYPlot, org.jfree.data.xy.XYDataset, int, int, int, org.jfree.chart.axis.ValueAxis, org.jfree.chart.axis.ValueAxis, java.awt.geom.Rectangle2D):void	org.jfree.chart.plot.XYPlot
org.jfree.data.general.WaferMapDataset::getUniqueValues():java.util.Set	org.jfree.data.DefaultKeyedValues2D
org.jfree.data.general.WaferMapDataset::getChipValue(java.lang.Comparable, java.lang.Comparable):java.lang.Number	org.jfree.data.DefaultKeyedValues2D
org.jfree.chart.axis.ModuloAxis::mapValueToFixedRange(double):double	org.jfree.data.Range
org.jfree.chart.plot.PolarPlot::refreshAngleTicks():java.util.List	org.jfree.chart.axis.TickUnit
org.jfree.chart.renderer.category.AbstractCategoryItemRenderer::updateCrosshairValues(org.jfree.chart.plot.CategoryCrosshairState, java.lang.Comparable, java.lang.Comparable, double, int, double, double, org.jfree.chart.plot.PlotOrientation):void	org.jfree.chart.plot.CategoryCrosshairState
org.jfree.chart.StandardChartTheme::applyToSpiderWebPlot(org.jfree.chart.plot.SpiderWebPlot):void	org.jfree.chart.plot.SpiderWebPlot
