br.com.linkcom.sgm.service.ObjetivoMapaEstrategicoService::createDesempenhoReport(DesempenhoReportFiltro):IReport	br.com.linkcom.sgm.service.UnidadeGerencialService	3. Indiferente
br.com.linkcom.sgm.beans.AcaoPreventiva::getPlanoGestao():PlanoGestao	br.com.linkcom.sgm.beans.PlanoGestao	1. Fortemente não Recomendado
br.com.linkcom.sgm.beans.Anomalia::getPlanoGestao():PlanoGestao	br.com.linkcom.sgm.beans.PlanoGestao	1. Fortemente não Recomendado
br.com.linkcom.sgm.beans.AuditoriaGestao::getDataAuditoria():Date	br.com.linkcom.sgm.beans.PlanoGestao	1. Fortemente não Recomendado
br.com.linkcom.sgm.beans.AuditoriaGestao::getPlanoGestao():PlanoGestao	br.com.linkcom.sgm.beans.PlanoGestao	1. Fortemente não Recomendado
br.com.linkcom.sgm.beans.AuditoriaInterna::getDataAuditoria():Date	br.com.linkcom.sgm.beans.PlanoGestao	1. Fortemente não Recomendado
br.com.linkcom.sgm.beans.DistribuicaoPesosIndicadores::getPlanoGestao():PlanoGestao	br.com.linkcom.sgm.beans.PlanoGestao	1. Fortemente não Recomendado
br.com.linkcom.sgm.beans.EmailHistoricoUsuario::getUsuarioEmail():String	br.com.linkcom.sgm.beans.EmailHistorico	1. Fortemente não Recomendado
br.com.linkcom.sgm.beans.Iniciativa::getUnidadeGerencial():UnidadeGerencial	br.com.linkcom.sgm.beans.UnidadeGerencial	1. Fortemente não Recomendado
br.com.linkcom.sgm.beans.ItemAuditoriaInterna::getDescricao():String	br.com.linkcom.sgm.beans.RequisitoNorma	1. Fortemente não Recomendado
br.com.linkcom.sgm.beans.MatrizFCSIniciativa::getMatrizFCS():MatrizFCS	br.com.linkcom.sgm.beans.MatrizFCS	1. Fortemente não Recomendado
br.com.linkcom.sgm.beans.Ocorrencia::getDataLancamento():Date	br.com.linkcom.sgm.beans.PlanoGestao	1. Fortemente não Recomendado
br.com.linkcom.sgm.beans.UnidadeGerencial::getMapaCompetencia():MapaCompetencia	br.com.linkcom.sgm.beans.MapaCompetencia	1. Fortemente não Recomendado
br.com.linkcom.sgm.beans.UnidadeGerencial::getMapaEstrategico():MapaEstrategico	br.com.linkcom.sgm.beans.MapaEstrategico	1. Fortemente não Recomendado
br.com.linkcom.sgm.beans.UnidadeGerencial::getMapaNegocio():MapaNegocio	br.com.linkcom.sgm.beans.MapaNegocio	1. Fortemente não Recomendado
br.com.linkcom.sgm.beans.UnidadeGerencial::getPlanoGestao():PlanoGestao	br.com.linkcom.sgm.beans.PlanoGestao	1. Fortemente não Recomendado
br.com.linkcom.sgm.beans.UnidadeGerencial::getSigla():String	br.com.linkcom.sgm.beans.NivelHierarquico	1. Fortemente não Recomendado
br.com.linkcom.sgm.controller.crud.AcaoPreventivaCrud::getAcompanhamentoIndicador(WebRequestContext):AcompanhamentoIndicador	br.com.linkcom.sgm.service.AcompanhamentoIndicadorService	1. Fortemente não Recomendado
br.com.linkcom.sgm.controller.crud.AnomaliaCrud::getAcompanhamentoIndicador(WebRequestContext):AcompanhamentoIndicador	br.com.linkcom.sgm.service.AcompanhamentoIndicadorService	1. Fortemente não Recomendado
br.com.linkcom.sgm.controller.crud.AnomaliaCrud::montaDiagramaCausaEfeito(Anomalia):void	br.com.linkcom.sgm.service.CausaEfeitoService	5. Fortemente Recomendado
br.com.linkcom.sgm.controller.crud.AuditoriaInternaCrud::ajaxComboRequisito(WebRequestContext):void	br.com.linkcom.sgm.service.RequisitoNormaService	1. Fortemente não Recomendado
br.com.linkcom.sgm.controller.crud.IndicadorCrud::copiar(WebRequestContext, Indicador):ModelAndView	br.com.linkcom.sgm.service.IndicadorService	1. Fortemente não Recomendado
br.com.linkcom.sgm.controller.filtro.DefinicaoEstrategiaFiltro::getPlanoGestao():PlanoGestao	br.com.linkcom.sgm.beans.PlanoGestao	1. Fortemente não Recomendado
br.com.linkcom.sgm.controller.filtro.IniciativaPlanoAcaoFiltro::getPlanoGestao():PlanoGestao	br.com.linkcom.sgm.beans.PlanoGestao	1. Fortemente não Recomendado
br.com.linkcom.sgm.controller.filtro.MatrizFCSFiltro::getPlanoGestao():PlanoGestao	br.com.linkcom.sgm.beans.PlanoGestao	1. Fortemente não Recomendado
br.com.linkcom.sgm.controller.filtro.PlanoGestaoUnidadeGerencialFiltro::getPlanoGestao():PlanoGestao	br.com.linkcom.sgm.beans.PlanoGestao	1. Fortemente não Recomendado
br.com.linkcom.sgm.controller.filtro.SolicitacaoCancelamentoIndicadorFiltro::getPlanoGestao():PlanoGestao	br.com.linkcom.sgm.beans.PlanoGestao	1. Fortemente não Recomendado
br.com.linkcom.sgm.controller.filtro.SolicitacaoRepactuacaoIndicadorFiltro::getPlanoGestao():PlanoGestao	br.com.linkcom.sgm.beans.PlanoGestao	1. Fortemente não Recomendado
br.com.linkcom.sgm.controller.IndexController::exec(WebRequestContext):ModelAndView	br.com.linkcom.sgm.service.PlanoGestaoService	1. Fortemente não Recomendado
br.com.linkcom.sgm.controller.IndexController::montaTabela(PlanoGestao, List<EstatisticaIndexDTO>):void	br.com.linkcom.sgm.service.UnidadeGerencialService	4. Recomendado
br.com.linkcom.sgm.controller.process.ApresentacaoResultadosProcess::setListaIndicadores(ApresentacaoResultadosDTO):ApresentacaoResultadosDTO	br.com.linkcom.sgm.service.IndicadorService	5. Fortemente Recomendado
br.com.linkcom.sgm.controller.process.DefinicaoCompetenciaProcess::salvar(WebRequestContext, UnidadeGerencial):ModelAndView	br.com.linkcom.sgm.service.MapaCompetenciaService	1. Fortemente não Recomendado
br.com.linkcom.sgm.controller.process.DefinicaoNegocioProcess::salvar(WebRequestContext, UnidadeGerencial):ModelAndView	br.com.linkcom.sgm.service.MapaNegocioService	1. Fortemente não Recomendado
br.com.linkcom.sgm.controller.process.DistribuicaoPesosIndicadoresProcess::isAdministradoOuDataLimiteNaoExpirada(Indicador):boolean	br.com.linkcom.sgm.service.IndicadorService	5. Fortemente Recomendado
br.com.linkcom.sgm.controller.process.DistribuicaoPesosIndicadoresProcess::resolveAcompanhamentos(PlanoGestao, Indicador):void	br.com.linkcom.sgm.service.AcompanhamentoIndicadorService	5. Fortemente Recomendado
br.com.linkcom.sgm.controller.process.DistribuicaoPesosIndicadoresProcess::salvarPopUpPlanoAcao(WebRequestContext, Iniciativa):ModelAndView	br.com.linkcom.sgm.service.IniciativaService	1. Fortemente não Recomendado
br.com.linkcom.sgm.controller.process.DistribuicaoPesosIndicadoresProcess::validaForm(Indicador, WebRequestContext):boolean	br.com.linkcom.sgm.service.AnexoIndicadorService	1. Fortemente não Recomendado
br.com.linkcom.sgm.controller.report.filtro.AlcanceMetaInstitucionalReportFiltro::getPlanoGestao():PlanoGestao	br.com.linkcom.sgm.beans.PlanoGestao	1. Fortemente não Recomendado
br.com.linkcom.sgm.controller.report.filtro.IndicadoresEstrategicoReportFiltro::getPlanoGestao():PlanoGestao	br.com.linkcom.sgm.beans.PlanoGestao	1. Fortemente não Recomendado
br.com.linkcom.sgm.controller.report.filtro.MatrizFCSReportFiltro::getPlanoGestao():PlanoGestao	br.com.linkcom.sgm.beans.PlanoGestao	1. Fortemente não Recomendado
br.com.linkcom.sgm.controller.report.filtro.PendenciaAnomaliaReportFiltro::getPlanoGestao():PlanoGestao	br.com.linkcom.sgm.beans.PlanoGestao	1. Fortemente não Recomendado
br.com.linkcom.sgm.controller.report.filtro.PendenciaCadastroReportFiltro::getPlanoGestao():PlanoGestao	br.com.linkcom.sgm.beans.PlanoGestao	1. Fortemente não Recomendado
br.com.linkcom.sgm.controller.UnidadeGerencialAutoCompleteController::view(WebRequestContext, UnidadeGerencialTreeFiltro):void	br.com.linkcom.sgm.controller.filtro.UnidadeGerencialTreeFiltro	1. Fortemente não Recomendado
br.com.linkcom.sgm.dao.AnomaliaDAO::existeAnomaliaVinculada(ItemAuditoriaInterna):Boolean	br.com.linkcom.sgm.dao.UnidadeGerencialDAO	1. Fortemente não Recomendado
br.com.linkcom.sgm.dao.AnomaliaDAO::fazParteAnomalia(Ocorrencia):Boolean	br.com.linkcom.sgm.dao.UnidadeGerencialDAO	1. Fortemente não Recomendado
br.com.linkcom.sgm.dao.AnomaliaDAO::findForAnomaliaSinteticoPorStatusReport(AnomaliaSinteticoPorStatusReportFiltro, StatusAnomaliaEnum):Integer	br.com.linkcom.sgm.dao.UnidadeGerencialDAO	1. Fortemente não Recomendado
br.com.linkcom.sgm.dao.AnomaliaDAO::findForReportListagemAnomalia(AnomaliaListagemReportFiltro):List<Anomalia>	br.com.linkcom.sgm.dao.UnidadeGerencialDAO	1. Fortemente não Recomendado
br.com.linkcom.sgm.dao.MapaCompetenciaDAO::loadByUnidadeGerencial(UnidadeGerencial):MapaCompetencia	br.com.linkcom.sgm.beans.UnidadeGerencial	1. Fortemente não Recomendado
br.com.linkcom.sgm.filtro.AcaoPreventivaFiltro::getPlanoGestao():PlanoGestao	br.com.linkcom.sgm.beans.PlanoGestao	1. Fortemente não Recomendado
br.com.linkcom.sgm.filtro.AnomaliaFiltro::getPlanoGestao():PlanoGestao	br.com.linkcom.sgm.beans.PlanoGestao	1. Fortemente não Recomendado
br.com.linkcom.sgm.filtro.AuditoriaInternaFiltro::getPlanoGestao():PlanoGestao	br.com.linkcom.sgm.beans.PlanoGestao	1. Fortemente não Recomendado
br.com.linkcom.sgm.filtro.PainelControleFiltro::getPlanoGestao():PlanoGestao	br.com.linkcom.sgm.beans.PlanoGestao	1. Fortemente não Recomendado
br.com.linkcom.sgm.service.AnomaliaService::createAnomaliaSinteticoPorStatusReport(AnomaliaSinteticoPorStatusReportFiltro):IReport	br.com.linkcom.sgm.service.UnidadeGerencialService	2. Não Recomendado
br.com.linkcom.sgm.service.AnomaliaService::makeDiagramaReport(Anomalia, Image, Image, Image):Report	br.com.linkcom.sgm.service.CausaEfeitoService	4. Recomendado
br.com.linkcom.sgm.service.AnomaliaService::salvaAnomalia(Anomalia, boolean):String	br.com.linkcom.sgm.service.PlanoAcaoService	1. Fortemente não Recomendado
br.com.linkcom.sgm.service.AuditoriaGestaoService::createAuditoriaGestaoReport(AuditoriaGestao):IReport	br.com.linkcom.sgm.service.ItemFatorAvaliacaoService	1. Fortemente não Recomendado
br.com.linkcom.sgm.service.AuditoriaInternaService::salvaAuditoriaInterna(AuditoriaInterna, boolean, boolean):String	br.com.linkcom.sgm.dao.AuditoriaInternaDAO	2. Não Recomendado
br.com.linkcom.sgm.service.ControleCadastroService::geraListaControleCadastro(PlanoGestao, List<UnidadeGerencial>):List<ControleCadastro>	br.com.linkcom.sgm.service.IniciativaService	1. Fortemente não Recomendado
br.com.linkcom.sgm.service.ControleCadastroService::montaItemControleCadastroMapaCompetencia(UnidadeGerencial, HttpServletRequest):ControleCadastroItem	br.com.linkcom.sgm.service.MapaCompetenciaService	2. Não Recomendado
br.com.linkcom.sgm.service.DistribuicaoPesosIndicadoresService::carregaElementosPainelIndicador(UnidadeGerencial):List<PerspectivaMapaEstrategico>	br.com.linkcom.sgm.service.PerspectivaMapaEstrategicoService	5. Fortemente Recomendado
br.com.linkcom.sgm.service.DistribuicaoPesosIndicadoresService::confereSomaPesoIndicadores(DistribuicaoPesosIndicadores, BindException):Boolean	br.com.linkcom.sgm.beans.DistribuicaoPesosIndicadores	3. Indiferente
br.com.linkcom.sgm.service.DistribuicaoPesosIndicadoresService::obtemListaPerspectivaObjetivoEstrategicoIniciativaIndicador(UnidadeGerencial, boolean, boolean, boolean):List<PerspectivaMapaEstrategico>	br.com.linkcom.sgm.service.ObjetivoMapaEstrategicoService	5. Fortemente Recomendado
br.com.linkcom.sgm.service.DistribuicaoPesosIndicadoresService::salvar(DistribuicaoPesosIndicadores):void	br.com.linkcom.sgm.service.IniciativaService	1. Fortemente não Recomendado
br.com.linkcom.sgm.service.IndicadorService::agruparPorFator(Indicador, int, List<Calendar>):List<AcompanhamentoIndicador>	br.com.linkcom.sgm.service.AcompanhamentoIndicadorService	2. Não Recomendado
br.com.linkcom.sgm.service.IndicadorService::createReportApresentacaoResultados(ApresentacaoResultadosDTO):IReport	br.com.linkcom.sgm.beans.DTO.ApresentacaoResultadosDTO	1. Fortemente não Recomendado
br.com.linkcom.sgm.service.PerspectivaMapaEstrategicoService::montaArvorePlanejamentoEstrategico(UnidadeGerencial, boolean, boolean, boolean):List<PerspectivaMapaEstrategico>	br.com.linkcom.sgm.service.IndicadorService	2. Não Recomendado
br.com.linkcom.sgm.service.PlanoGestaoService::copiaPlanoGestao(PlanoGestao, PlanoGestao):void	br.com.linkcom.sgm.dao.PlanoGestaoDAO	2. Não Recomendado
br.com.linkcom.sgm.service.PlanoGestaoService::createReportPendenciaCadastro(PlanoGestao, List<UnidadeGerencial>):IReport	br.com.linkcom.sgm.service.ControleCadastroService	5. Fortemente Recomendado
br.com.linkcom.sgm.service.UnidadeGerencialService::concatenaNomesResponsaveisUnidadeGerencial(UnidadeGerencial):String	br.com.linkcom.sgm.service.UsuarioUnidadeGerencialService	2. Não Recomendado
br.com.linkcom.sgm.service.UnidadeGerencialService::createMapaCompetenciaReport(MapaCompetenciaReportFiltro):Resource	br.com.linkcom.sgm.service.UsuarioService	2. Não Recomendado
br.com.linkcom.sgm.service.UnidadeGerencialService::createReportAlcanceMetaInstitucional(WebRequestContext, AlcanceMetaInstitucionalReportFiltro):IReport	br.com.linkcom.sgm.service.PlanoGestaoService	4. Recomendado
br.com.linkcom.sgm.service.UsuarioUnidadeGerencialService::findResponsaveisByUnidadeGerencial(UnidadeGerencial):List<UsuarioUnidadeGerencial>	br.com.linkcom.sgm.dao.UsuarioUnidadeGerencialDAO	2. Não Recomendado
